	0
alegria	alegria
medo	medo
nojo	nojo
raiva	raiva
tristeza	tristeza
animação	alegria
pavor	medo
asco	nojo
fúria	raiva
infelicidade	tristeza
alacridade	alegria
fobia	medo
aversão	nojo
ira	raiva
desânimo	tristeza
agrado	alegria
horror	medo
náusea	nojo
cólera	raiva
tristura	tristeza
felicidade	alegria
terror	medo
enjoo	nojo
irritação	raiva
descontentamento	tristeza
prazer	alegria
pânico	medo
repugnância	nojo
ódio	raiva
abatimento	tristeza
aprazimento	alegria
temor	medo
repulsão	nojo
gana	raiva
melancolia	tristeza
euforia	alegria
susto	medo
repulsa	nojo
furor	raiva
desalento	tristeza
bem-estar	alegria
ojeriza	medo
fastio	nojo
zanga	raiva
desolação	tristeza
bom humor	alegria
amedrontamento	medo
abominação	nojo
agressividade	raiva
desconsolo	tristeza
comprazimento	alegria
receio	medo
animosidade	nojo
sanha	raiva
insatisfação	tristeza
contentamento	alegria
apreensão	medo
enojo	nojo
exasperação	raiva
esmorecimento	tristeza
contento	alegria
preocupação	medo
engulho	nojo
frustração	raiva
prostração	tristeza
deleitação	alegria
ansiedade	medo
antojo	nojo
indignação	raiva
depressão	tristeza
deleitamento	alegria
inquietação	medo
luto	nojo
antipatia	raiva
desesperança	tristeza
deleite	alegria
incerteza	medo
dó	nojo
odiosidade	raiva
mágoa	tristeza
desfastio	alegria
dúvida	medo
pesar	nojo
execração	raiva
desgosto	tristeza
enlevo	alegria
covardia	medo
crepe	nojo
desprezo	raiva
sofrimento	tristeza
entusiasmo	alegria
fraqueza	medo
cipreste	nojo
rancor	raiva
aflição	tristeza
gáudio	alegria
frouxidão	medo
vergonha	nojo
ressentimento	raiva
angústia	tristeza
gosto	alegria
poltronaria	medo
pudor	nojo
hidrofobia	raiva
consternação	tristeza
gozo	alegria
pusilanimidade	medo
recato	nojo
danação	raiva
dissabor	tristeza
jovialidade	alegria
poltronice	medo
decoro	nojo
moléstia	raiva
amargura	tristeza
jubilação	alegria
ignávia	medo
pejo	nojo
desejo	raiva
dor	tristeza
júbilo	alegria
médico	medo
constrangimento	nojo
apetite	raiva
pena	tristeza
jucundidade	alegria
camarção	medo
tédio	nojo
ânsia	raiva
padecimento	tristeza
jubilidade	alegria
espanto	medo
mal-estar	nojo
arrebatamento	raiva
azar	tristeza
ledice	alegria
alarma	medo
repelência	nojo
assanhamento	raiva
desgraça	tristeza
regozijo	alegria
cagaço	medo
afronta	nojo
exaltação	raiva
fatalidade	tristeza
satisfação	alegria
estarrecimento	medo
estuação	nojo
castigo	raiva
desdita	tristeza
oásis	alegria
intolerância	medo
agonia	nojo
punição	raiva
desventura	tristeza
carinho	alegria
crueldade	medo
naupatia	nojo
vingança	raiva
infortúnio	tristeza
carícia	alegria
monstruosidade	medo
peso	nojo
vontade	raiva
misantropia	tristeza
afago	alegria
barbaridade	medo
tontura	nojo
garra	raiva
aborto	tristeza
cortesia	alegria
atrocidade	medo
abuso	nojo
anseio	raiva
mal	tristeza
educação	alegria
hediondez	medo
entojo	nojo
avidez	raiva
adversidade	tristeza
gentileza	alegria
selvajaria	medo
aborrecimento	nojo
sofreguidão	raiva
calamidade	tristeza
gratificação	alegria
desumanidade	medo
enfado	nojo
voracidade	raiva
catástrofe	tristeza
gorjeta	alegria
bestialidade	medo
enfaro	nojo
fome	raiva
revés	tristeza
caixinha	alegria
crime	medo
asca	nojo
impulso	raiva
tragédia	tristeza
beneplácito	alegria
feiura	medo
enjeitamento	nojo
ímpeto	raiva
tormento	tristeza
consentimento	alegria
monstro	medo
entejo	nojo
rompante	raiva
mesquinhez	tristeza
aprovação	alegria
bicho	medo
estranhamento	nojo
repente	raiva
contratempo	tristeza
prazimento	alegria
diabo	medo
repúdio	nojo
arroubo	raiva
intempérie	tristeza
mimo	alegria
mostrengo	medo
resistência	nojo
acesso	raiva
volta	tristeza
agradecimento	alegria
canhão	medo
oposição	nojo
malquerença	raiva
lástima	tristeza
perfume	alegria
bruxa	medo
objeção	nojo
excitação	raiva
golpe	tristeza
complacência	alegria
bruaca	medo
contestação	nojo
ardor	raiva
derrota	tristeza
delícia	alegria
xaveco	medo
denegação	nojo
fervor	raiva
sorte	tristeza
volúpia	alegria
bagulho	medo
divergência	nojo
êxtase	raiva
negrura	tristeza
comodidade	alegria
jararaca	medo
impugnação	nojo
frenesi	raiva
negrume	tristeza
conveniência	alegria
bucho	medo
nega	nojo
impetuosidade	raiva
miséria	tristeza
sanção	alegria
desagrado	medo
negaça	nojo
moda	raiva
sentimento	tristeza
cômodo	alegria
desprazer	medo
negação	nojo
repelo	raiva
moleza	tristeza
bem-aventurança	alegria
contrariedade	medo
negamento	nojo
violência	raiva
atribulação	tristeza
ventura	alegria
dificuldade	medo
recusa	nojo
voga	raiva
caiporismo	tristeza
dita	alegria
amofinação	medo
refusão	nojo
onda	raiva
casmurrice	tristeza
fortuna	alegria
dinheirão	medo
refutação	nojo
loucura	raiva
hipocondria	tristeza
sucesso	alegria
dinheirada	medo
rejeição	nojo
paixão	raiva
insucesso	tristeza
êxito	alegria
dinheirama	medo
anorexia	nojo
desespero	raiva
macaca	tristeza
triunfo	alegria
exorbitância	medo
cansaço	nojo
embravecimento	raiva
mofina	tristeza
vitória	alegria
batelada	medo
canseira	nojo
encarniçamento	raiva
morrinha	tristeza
acerto	alegria
monte	medo
fadiga	nojo
tesão	raiva
suicídio	tristeza
glória	alegria
montão	medo
inapetência	nojo
força	raiva
taciturnidade	tristeza
congratulações	alegria
quantidade	medo
quebreira	nojo
elã	raiva
transtorno	tristeza
felicitações	alegria
abundância	medo
sufocação	nojo
agastamento	raiva
urucubaca	tristeza
cumprimentos	alegria
enxurrada	medo
saciedade	nojo
amolação	raiva
vicissitude	tristeza
exultação	alegria
porção	medo
displicência	nojo
enguiço	raiva
zica	tristeza
regalo	alegria
profusão	medo
monotonia	nojo
feitiço	raiva
tanglomanglo	tristeza
distração	alegria
série	medo
xarope	nojo
mau-olhado	raiva
malemolência	tristeza
diversão	alegria
chorrilho	medo
hostilidade	nojo
quebranto	raiva
decepção	tristeza
divertimento	alegria
mundo	medo
animadversão	nojo
incompatibilidade	raiva
inconformação	tristeza
entretenimento	alegria
mundaréu	medo
inimizade	nojo
braveza	raiva
desprazimento	tristeza
passatempo	alegria
amontoado	medo
prevenção	nojo
enfurecimento	raiva
malgrado	tristeza
recreação	alegria
intensamente	medo
calor	nojo
ferocidade	raiva
abate	tristeza
satisfazer	alegria
muito	medo
veemência	nojo
briga	raiva
nirvana	tristeza
comprazer	alegria
bastante	medo
arrojo	nojo
desavença	raiva
baixa	tristeza
aprazer	alegria
imenso	medo
audácia	nojo
luta	raiva
rebaixamento	tristeza
agradar	alegria
demais	medo
bravura	nojo
rixa	raiva
debilidade	tristeza
permissão	alegria
demasiado	medo
brio	nojo
avaria	raiva
enfraquecimento	tristeza
alvoroço	alegria
demasiadamente	medo
coragem	nojo
defeito	raiva
acabrunhamento	tristeza
amenidade	alegria
excessivamente	medo
determinação	nojo
falha	raiva
abaixamento	tristeza
calma	alegria
exageradamente	medo
disposição	nojo
agressão	raiva
dedução	tristeza
conforto	alegria
respeito	medo
intrepidez	nojo
hostilização	raiva
desconto	tristeza
despreocupação	alegria
caguira	medo
ousadia	nojo
ofensa	raiva
diminuição	tristeza
otimismo	alegria
sobrosso	medo
valentia	nojo
dureza	raiva
humilhação	tristeza
tranquilidade	alegria
reverência	medo
enojamento	nojo
brutalidade	raiva
languidez	tristeza
aconchego	alegria
obediência	medo
chateação	nojo
belicosidade	raiva
palerma	tristeza
saúde	alegria
veneração	medo
ambição	nojo
dinamismo	raiva
abalo	tristeza
segurança	alegria
sobressalto	medo
desinteresse	nojo
energia	raiva
caimento	tristeza
beatitude	alegria
desassossego	medo
vazio	nojo
empreendimento	raiva
decadência	tristeza
bem	alegria
inquietude	medo
pasmaceira	nojo
atividade	raiva
declínio	tristeza
independência	alegria
assombro	medo
apatia	nojo
cisma	raiva
ruína	tristeza
prosperidade	alegria
ameaça	medo
morte	nojo
antagonismo	raiva
escuridão	tristeza
benevolência	alegria
tremor	medo
anojamento	nojo
desafeição	raiva
baixeza	tristeza
benignidade	alegria
pontualidade	medo
solda	nojo
implicação	raiva
indiferença	tristeza
condescendência	alegria
zelo	medo
noite	nojo
implicância	raiva
anemia	tristeza
estorvo	alegria
diligência	medo
abalançar	nojo
pontinha	raiva
astenia	tristeza
conteúdo	alegria
empenho	medo
romanear	nojo
quizília	raiva
letargia	tristeza
doçura	alegria
rigor	medo
sopesar	nojo
teiró	raiva
estrago	tristeza
desenfado	alegria
escrúpulo	medo
avaliar	nojo
alergia	raiva
fossa	tristeza
maravilha	alegria
cuidado	medo
apreciar	nojo
contragosto	raiva
diferença	tristeza
alienação	alegria
salto	medo
analisar	nojo
embirração	raiva
arrefecimento	tristeza
absorção	alegria
surpresa	medo
considerar	nojo
quizila	raiva
redução	tristeza
delírio	alegria
tremura	medo
estimar	nojo
mau humor	raiva
desgaste	tristeza
endeusamento	alegria
espavento	medo
estudar	nojo
desdém	raiva
matança	tristeza
embevecimento	alegria
alarme	medo
examinar	nojo
desconsideração	raiva
lentidão	tristeza
enlevamento	alegria
assombração	medo
observar	nojo
desapreço	raiva
esgotamento	tristeza
fascínio	alegria
peladura	medo
ponderar	nojo
descaso	raiva
torpor	tristeza
transporte	alegria
acovardamento	medo
presumir	nojo
frieza	raiva
opressão	tristeza
suspensão	alegria
intranquilidade	medo
imaginar	nojo
desatenção	raiva
aniquilamento	tristeza
embriaguez	alegria
intimidação	medo
calcular	nojo
menosprezo	raiva
atimia	tristeza
encanto	alegria
consumição	medo
conjecturar	nojo
menoscabo	raiva
derrubada	tristeza
enleio	alegria
mortificação	medo
prever	nojo
depreciação	raiva
descaimento	tristeza
anagogia	alegria
desconfiança	medo
supor	nojo
vilipêndio	raiva
desvalorização	tristeza
contemplação	alegria
pressentimento	medo
influenciar	nojo
detração	raiva
lombeira	tristeza
espasmo	alegria
hesitação	medo
atuar	nojo
pouco-caso	raiva
marasmo	tristeza
enlevação	alegria
suspeita	medo
induzir	nojo
desrespeito	raiva
morbidez	tristeza
voo	alegria
suspeição	medo
influir	nojo
desacato	raiva
nostalgia	tristeza
pasto	alegria
arquejo	medo
instigar	nojo
negligência	raiva
quebra	tristeza
riso	alegria
estertor	medo
intervir	nojo
desfavor	raiva
quebradeira	tristeza
flama	alegria
impaciência	medo
motivar	nojo
desamor	raiva
quebramento	tristeza
interesse	alegria
vasca	medo
sugestionar	nojo
desculto	raiva
quebrantamento	tristeza
vida	alegria
estresse	medo
recair	nojo
desprendimento	raiva
amortização	tristeza
vigor	alegria
stress	medo
incidir	nojo
abandono	raiva
bônus	tristeza
admiração	alegria
aspiração	medo
apertar	nojo
desapego	raiva
inanição	tristeza
encantamento	alegria
ofego	medo
calcar	nojo
alheamento	raiva
subtração	tristeza
frenesim	alegria
anelo	medo
estender-se	nojo
renúncia	raiva
umbigo	tristeza
centelha	alegria
anelação	medo
imprensar	nojo
abnegação	raiva
decremento	tristeza
estro	alegria
confusão	medo
oprimir	nojo
isenção	raiva
depleção	tristeza
iluminação	alegria
dubiedade	medo
premer	nojo
relutância	raiva
adelgaçamento	tristeza
inspiração	alegria
ambiguidade	medo
prensar	nojo
queixa	raiva
saudade	tristeza
lampejo	alegria
dubiez	medo
pressionar	nojo
despeito	raiva
banzo	tristeza
sopro	alegria
imprecisão	medo
sobrecarregar	nojo
fel	raiva
derrotismo	tristeza
transe	alegria
indecisão	medo
abater	nojo
melindre	raiva
desconforto	tristeza
paladar	alegria
indefinição	medo
aborrecer	nojo
ciúme	raiva
malacia	tristeza
gustação	alegria
indeterminação	medo
chatear	nojo
escamação	raiva
viuvez	tristeza
sabor	alegria
insegurança	medo
desagradar	nojo
mossa	raiva
desconsolação	tristeza
sensação	alegria
interrogação	medo
descontentar	nojo
ressaibo	raiva
afeição	tristeza
palato	alegria
irresolução	medo
desgostar	nojo
higrofobia	raiva
sufoco	tristeza
saibo	alegria
oscilação	medo
estorvar	nojo
querer	raiva
pecado	tristeza
apetência	alegria
perplexidade	medo
importunar	nojo
cobiça	raiva
trauma	tristeza
aptidão	alegria
vacilação	medo
incomodar	nojo
cupidez	raiva
desmaio	tristeza
propensão	alegria
cobardia	medo
maçar	nojo
febre	raiva
desfalecimento	tristeza
predileção	alegria
tremelique	medo
magoar	nojo
apego	raiva
síncope	tristeza
predisposição	alegria
maricagem	medo
perturbar	nojo
sede	raiva
preguiça	tristeza
inclinação	alegria
adinamia	medo
apiedar	nojo
lubricidade	raiva
amortecimento	tristeza
tendência	alegria
fragilidade	medo
comiserar	nojo
tentação	raiva
chatice	tristeza
preferência	alegria
atonia	medo
comover	nojo
fantasia	raiva
perda	tristeza
simpatia	alegria
debilitação	medo
compadecer	nojo
concupiscência	raiva
má sorte	tristeza
queda	alegria
definhamento	medo
compungir	nojo
atração	raiva
desastre	tristeza
fraco	alegria
depauperação	medo
condoer	nojo
atração física	raiva
tribulação	tristeza
pendor	alegria
esfalfamento	medo
consternar	nojo
libido	raiva
desfortúnio	tristeza
habilidade	alegria
extenuação	medo
contristar	nojo
apetite sexual	raiva
desgraceira	tristeza
vocação	alegria
fraqueira	medo
emocionar	nojo
lascívia	raiva
amuo	tristeza
veia	alegria
neurastenia	medo
enternecer	nojo
propósito	raiva
agrura	tristeza
sensibilidade	alegria
acobardamento	medo
entristecer	nojo
pretensão	raiva
desilusão	tristeza
bom gosto	alegria
desbrio	medo
molestar	nojo
desígnio	raiva
desapontamento	tristeza
elegância	alegria
tibiez	medo
penalizar	nojo
intenção	raiva
desencanto	tristeza
finura	alegria
tibieza	medo
sensibilizar	nojo
intento	raiva
desencantamento	tristeza
fineza	alegria
timidez	medo
tocar	nojo
intuito	raiva
arrependimento	tristeza
refinamento	alegria
vício	medo
equilibrar-se	nojo
capricho	raiva
penar	tristeza
requinte	alegria
deficiência	medo
compaixão	nojo
devaneio	raiva
suplício	tristeza
esmero	alegria
deformidade	medo
compunção	nojo
extravagância	raiva
martírio	tristeza
primor	alegria
desdouro	medo
contrição	nojo
mania	raiva
calvário	tristeza
discrição	alegria
deslustre	medo
nuvem	nojo
obstinação	raiva
prova	tristeza
harmonia	alegria
eiva	medo
pesadume	nojo
sonho	raiva
provação	tristeza
maneira	alegria
falta	medo
remorso	nojo
teimosia	raiva
tortura	tristeza
modo	alegria
imperfeição	medo
problema	nojo
veleidade	raiva
penúria	tristeza
jeito	alegria
ineficácia	medo
pepino	nojo
veneta	raiva
pobreza	tristeza
estilo	alegria
ineficiência	medo
fumo	nojo
rasgo	raiva
flagelo	tristeza
forma	alegria
inutilidade	medo
braçal	nojo
alvitre	raiva
paciência	tristeza
critério	alegria
labéu	medo
vexame	nojo
arbítrio	raiva
resignação	tristeza
opinião	alegria
mácula	medo
desonra	nojo
bel-prazer	raiva
conformação	tristeza
discernimento	alegria
mancha	medo
enxovalho	nojo
cabeça	raiva
conformidade	tristeza
escolha	alegria
senão	medo
opróbrio	nojo
juízo	raiva
tolerância	tristeza
mercê	alegria
indefensabilidade	medo
ignomínia	nojo
ganância	raiva
incômodo	tristeza
talante	alegria
vulnerabilidade	medo
demérito	nojo
precedência	raiva
maçada	tristeza
opção	alegria
delicadeza	medo
descrédito	nojo
primazia	raiva
apoquentação	tristeza
retribuição	alegria
subtileza	medo
aviltamento	nojo
amor	raiva
aperreação	tristeza
recompensa	alegria
palidez	medo
desdoiro	nojo
lazeira	raiva
insipidez	tristeza
festa	alegria
pasmo	medo
indisposição	nojo
ataque	raiva
azarão	tristeza
aleluia	alegria
choque	medo
náuseas	nojo
agitação	raiva
baldão	tristeza
rejubilação	alegria
estupefação	medo
achaque	nojo
alma	raiva
imprevisto	tristeza
sol	alegria
estuporação	medo
enfermidade	nojo
movimento	raiva
acaso	tristeza
amizade	alegria
estranheza	medo
doença	nojo
fissura	raiva
acontecimento	tristeza
apreço	alegria
estranhez	medo
treco	nojo
súbito	raiva
casualidade	tristeza
brandura	alegria
aviso	medo
mazela	nojo
vivacidade	raiva
evento	tristeza
consideração	alegria
balbúrdia	medo
disforia	nojo
abrasamento	raiva
eventualidade	tristeza
cafuné	alegria
brado	medo
andaço	nojo
focagem	raiva
ocorrência	tristeza
meiguice	alegria
rebate	medo
embaraço	nojo
gama	raiva
acarretar	tristeza
ternura	alegria
sinal	medo
acanhamento	nojo
incandescência	raiva
causar	tristeza
atenção	alegria
tumulto	medo
agravo	nojo
instinto	raiva
ocasionar	tristeza
desvelo	alegria
celeuma	medo
desfeita	nojo
rapto	raiva
originar	tristeza
proteção	alegria
repique	medo
doesto	nojo
surto	raiva
provocar	tristeza
festinhas	alegria
crueza	medo
infâmia	nojo
empolgação	raiva
destino	tristeza
blandície	alegria
selvageria	medo
injúria	nojo
assanho	raiva
fado	tristeza
adulação	alegria
impiedade	medo
insulto	nojo
desaforo	raiva
drama	tristeza
festas	alegria
truculência	medo
pirraça	nojo
penalidade	raiva
fatalismo	tristeza
afagamento	alegria
maldade	medo
provocação	nojo
sentença	raiva
emergência	tristeza
blandícia	alegria
malignidade	medo
ultraje	nojo
condenação	raiva
sinistro	tristeza
lisonja	alegria
malvadeza	medo
vitupério	nojo
correção	raiva
urgência	tristeza
amabilidade	alegria
perversidade	medo
vergonheira	nojo
corretivo	raiva
raio	tristeza
apaparico	alegria
improbidade	medo
vexação	nojo
emenda	raiva
estrela	tristeza
favor	alegria
barbárie	medo
dispneia	nojo
exemplo	raiva
sina	tristeza
paparico	alegria
barbaria	medo
estafa	nojo
preço	raiva
descalabro	tristeza
apoio	alegria
barbarismo	medo
exaustão	nojo
penitência	raiva
desfortuna	tristeza
benesse	alegria
ruindade	medo
falta de ar	nojo
expiação	raiva
antropofobia	tristeza
favorecimento	alegria
inumanidade	medo
lassidão	nojo
imposição	raiva
insociabilidade	tristeza
graça	alegria
severidade	medo
moedeira	nojo
coima	raiva
introversão	tristeza
polidez	alegria
inflexibilidade	medo
assalto	nojo
escarmento	raiva
isolamento	tristeza
cordialidade	alegria
intransigência	medo
combate	nojo
vindita	raiva
afastamento	tristeza
afabilidade	alegria
irredutibilidade	medo
invectiva	nojo
látego	raiva
reclusão	tristeza
graciosidade	alegria
inclemência	medo
investida	nojo
repreensão	raiva
retraimento	tristeza
deferência	alegria
aspereza	medo
afrontação	nojo
bronca	raiva
reserva	tristeza
cavalheirismo	alegria
acerbidade	medo
afrontamento	nojo
reprimenda	raiva
abortamento	tristeza
política	alegria
insensibilidade	medo
confronto	nojo
advertência	raiva
desmancho	tristeza
polimento	alegria
impassibilidade	medo
aperto	nojo
chamada	raiva
amblose	tristeza
lhaneza	alegria
sangue-frio	medo
afligimento	nojo
admoestação	raiva
móvito	tristeza
urbanidade	alegria
anomalia	medo
atormentação	nojo
lição	raiva
fracasso	tristeza
civilidade	alegria
aleijão	medo
colapso	nojo
ensinadela	raiva
malogro	tristeza
solicitude	alegria
cacogênese	medo
involução	nojo
sermão	raiva
fiasco	tristeza
galanteria	alegria
enormidade	medo
perecimento	nojo
carraspana	raiva
falhanço	tristeza
cerimônia	alegria
judiaria	medo
derrocada	nojo
descompostura	raiva
deformação	tristeza
cumprimento	alegria
judiação	medo
depauperamento	nojo
sabão	raiva
anormalidade	tristeza
vênia	alegria
teratismo	medo
descensão	nojo
sarabanda	raiva
aberração	tristeza
mesura	alegria
disparate	medo
pressa	nojo
censura	raiva
desvio	tristeza
saudação	alegria
absurdo	medo
correria	nojo
cautério	raiva
monstrengo	tristeza
salva	alegria
desatino	medo
precipitação	nojo
importunação	raiva
fealdade	tristeza
cortejo	alegria
tirania	medo
afobação	nojo
espalhanço	raiva
inadequadamente	tristeza
rapapé	alegria
heresia	medo
azáfama	nojo
surra	raiva
ilegalmente	tristeza
salamaleque	alegria
contrassenso	medo
açodamento	nojo
sova	raiva
desarmoniosamente	tristeza
zumbaia	alegria
fereza	medo
afã	nojo
espancamento	raiva
erradamente	tristeza
presente	alegria
sevícia	medo
apuro	nojo
pancadaria	raiva
defeituosamente	tristeza
lembrança	alegria
canibalismo	medo
demora	nojo
pau	raiva
incorretamente	tristeza
oferta	alegria
animal	medo
arranco	nojo
bordoada	raiva
irregularmente	tristeza
prenda	alegria
sangue	medo
pieira	nojo
esfrega	raiva
de leve	tristeza
homenagem	alegria
indignidade	medo
gravidade	nojo
trepa	raiva
deficientemente	tristeza
tributo	alegria
excesso	medo
bagagem	nojo
tosa	raiva
imperfeitamente	tristeza
louvor	alegria
malícia	medo
carga	nojo
tosquiadela	raiva
incompletamente	tristeza
preito	alegria
inconsciência	medo
carregamento	nojo
tareia	raiva
insatisfatoriamente	tristeza
benefício	alegria
iniquidade	medo
carrego	nojo
escovadela	raiva
insuficientemente	tristeza
obséquio	alegria
maus-tratos	medo
fardo	nojo
açoite	raiva
pouco	tristeza
distinção	alegria
animalidade	medo
frete	nojo
malha	raiva
rapidamente	tristeza
donaire	alegria
estupidez	medo
volume	nojo
malhação	raiva
a custo	tristeza
galhardia	alegria
transgressão	medo
ascendência	nojo
alvedrio	raiva
apenas	tristeza
garbo	alegria
infração	medo
autoridade	nojo
líbito	raiva
com dificuldade	tristeza
garbosidade	alegria
violação	medo
crédito	nojo
mando	raiva
desfavoravelmente	tristeza
propina	alegria
delito	medo
importância	nojo
moto-próprio	raiva
dificilmente	tristeza
adiafa	alegria
tropeço	medo
influência	nojo
nução	raiva
dificultosamente	tristeza
emolumento	alegria
engano	medo
mérito	nojo
poder	raiva
negativamente	tristeza
espórtula	alegria
equívoco	medo
prestígio	nojo
volição	raiva
penosamente	tristeza
lambidela	alegria
erro	medo
valor	nojo
dedicação	raiva
barbaramente	tristeza
molha	alegria
deslize	medo
ânimo	nojo
aplicação	raiva
bruscamente	tristeza
molhadela	alegria
criminalidade	medo
culpa	nojo
firmeza	raiva
cruelmente	tristeza
molhadura	alegria
delinquência	medo
compromisso	nojo
capricheira	raiva
desumanamente	tristeza
mota	alegria
incoerência	medo
dever	nojo
decisão	raiva
duramente	tristeza
cafezinho	alegria
despautério	medo
encargo	nojo
deliberação	raiva
grosseiramente	tristeza
cerveja	alegria
despropósito	medo
incumbência	nojo
ordem	raiva
impropriamente	tristeza
copinho	alegria
ilogismo	medo
obrigação	nojo
resolução	raiva
inconvenientemente	tristeza
cinzel	alegria
irracionalidade	medo
ônus	nojo
carência	raiva
indevidamente	tristeza
escopro	alegria
feioso	medo
responsabilidade	nojo
precisão	raiva
injustamente	tristeza
caixote	alegria
criatura	medo
halter	nojo
necessidade	raiva
rudemente	tristeza
relicário	alegria
ogro	medo
haltere	nojo
à vontade	raiva
severamente	tristeza
boceta	alegria
besta	medo
tonteira	nojo
boa vontade	raiva
jamais	tristeza
xixica	alegria
desumano	medo
delíquio	nojo
unha	raiva
não	tristeza
licença	alegria
cruel	medo
atordoamento	nojo
dedo	raiva
nunca	tristeza
autorização	alegria
malvado	medo
aturdimento	nojo
mão	raiva
assim que	tristeza
concessão	alegria
desalmado	medo
vertigem	nojo
gadanho	raiva
logo que	tristeza
concordância	alegria
perverso	medo
perturbação	nojo
gafa	raiva
acidente	tristeza
anuência	alegria
bárbaro	medo
zonzeira	nojo
grifo	raiva
dano	tristeza
aquiescência	alegria
atroz	medo
descomedimento	nojo
gatázio	raiva
maldição	tristeza
assentimento	alegria
diabólico	medo
exagero	nojo
afinco	raiva
prejuízo	tristeza
deferimento	alegria
fera	medo
imoderação	nojo
persistência	raiva
adoecimento	tristeza
aceitação	alegria
carrasco	medo
arrogância	nojo
perseverança	raiva
distúrbio	tristeza
outorga	alegria
celerado	medo
atrevimento	nojo
tenacidade	raiva
morbo	tristeza
aval	alegria
fenômeno	medo
cinismo	nojo
fibra	raiva
desvantagem	tristeza
adesão	alegria
portento	medo
desavergonhamento	nojo
esforço	raiva
inconveniência	tristeza
aderência	alegria
prodígio	medo
descaramento	nojo
intensidade	raiva
malefício	tristeza
acedência	alegria
colosso	medo
desfaçatez	nojo
constância	raiva
malevolência	tristeza
acessão	alegria
gênio	medo
desplante	nojo
rapacidade	raiva
malfeito	tristeza
assenso	alegria
enorme	medo
insolência	nojo
domínio	raiva
nocividade	tristeza
transigência	alegria
gigante	medo
petulância	nojo
controle	raiva
perniciosidade	tristeza
indulgência	alegria
gigantesco	medo
sem-vergonhice	nojo
jugo	raiva
mal-entendido	tristeza
flexibilidade	alegria
colossal	medo
sem-vergonhismo	nojo
dominação	raiva
foi mal	tristeza
contemporização	alegria
descomunal	medo
arbitrariedade	nojo
prepotência	raiva
borrasca	tristeza
compreensão	alegria
desmedido	medo
despotismo	nojo
gavinha	raiva
impedimento	tristeza
consenso	alegria
alimária	medo
defloramento	nojo
cirro	raiva
inversão	tristeza
unanimidade	alegria
animalejo	medo
desfloração	nojo
elo	raiva
óbice	tristeza
entendimento	alegria
animália	medo
estupro	nojo
expectativa	raiva
obstáculo	tristeza
acordo	alegria
asno	medo
superstição	nojo
tensão	raiva
percalço	tristeza
consonância	alegria
bichano	medo
crendice	nojo
gula	raiva
cataclismo	tristeza
oferenda	alegria
bicho-de-pé	medo
abusão	nojo
avareza	raiva
apocalipse	tristeza
brinde	alegria
burro	medo
estopada	nojo
inveja	raiva
hecatombe	tristeza
dádiva	alegria
cupim	medo
arrufo	nojo
usura	raiva
armagedom	tristeza
beleza	alegria
inseto	medo
vácuo	nojo
edacidade	raiva
devastação	tristeza
perfeição	alegria
piolho	medo
arrenegação	nojo
glutonaria	raiva
destruição	tristeza
brinco	alegria
térmite	medo
enfadamento	nojo
esganação	raiva
epidemia	tristeza
joia	alegria
traça	medo
flagelação	nojo
olho grande	raiva
convulsão	tristeza
suavidade	alegria
verme	medo
seca	nojo
intemperança	raiva
praga	tristeza
brinco-de-princesa	alegria
bruto	medo
descarte	nojo
destemperança	raiva
apertura	tristeza
fúcsia	alegria
cavalo	medo
despojo	nojo
alarvaria	raiva
espinho	tristeza
lágrima	alegria
estúpido	medo
refugo	nojo
orexia	raiva
perseguição	tristeza
gratidão	alegria
grosseiro	medo
despojamento	nojo
desnutrição	raiva
inferno	tristeza
gratulação	alegria
grosso	medo
abstenção	nojo
subalimentação	raiva
complicação	tristeza
reconhecimento	alegria
mal-educado	medo
desabrigo	nojo
subnutrição	raiva
trato	tristeza
compensação	alegria
corajoso	medo
desamparo	nojo
escassez	raiva
véu	tristeza
paga	alegria
decidido	medo
desarrimo	nojo
indigência	raiva
obsessão	tristeza
pagamento	alegria
desassombrado	medo
descuramento	nojo
inópia	raiva
perigo	tristeza
prêmio	alegria
amigo	medo
desleixo	nojo
míngua	raiva
atenazamento	tristeza
recompensação	alegria
camarada	medo
esquecimento	nojo
privação	raiva
dolência	tristeza
aroma	alegria
cara	medo
descuido	nojo
rafa	raiva
cilício	tristeza
odor	alegria
chapa	medo
desproteção	nojo
unha de fome	raiva
cruz	tristeza
bálsamo	alegria
fulano	medo
fora	nojo
alor	raiva
espinha	tristeza
cheiro	alegria
ás	medo
negativa	nojo
lance	raiva
pesadelo	tristeza
eflúvio	alegria
bom	medo
desacolhimento	nojo
pulsão	raiva
sobrecarga	tristeza
essência	alegria
especialista	medo
preterição	nojo
encorajamento	raiva
traspasso	tristeza
fragrância	alegria
exímio	medo
repudiação	nojo
estímulo	raiva
mesquinharia	tristeza
olência	alegria
experto	medo
ostracismo	nojo
incentivo	raiva
vileza	tristeza
olor	alegria
perito	medo
desaceitação	nojo
incitamento	raiva
sordidez	tristeza
água-de-colônia	alegria
bonificação	medo
renunciação	nojo
instigação	raiva
insignificância	tristeza
colônia	alegria
aprendiz	medo
distanciamento	nojo
arranque	raiva
pequenez	tristeza
unção	alegria
calouro	medo
inaptidão	nojo
empurrão	raiva
sovinice	tristeza
conchego	alegria
estudante	medo
incapacidade	nojo
impulsão	raiva
vilania	tristeza
descanso	alegria
iniciante	medo
negra	nojo
impulsionamento	raiva
agarramento	tristeza
adequação	alegria
novato	medo
impede	nojo
pulso	raiva
estreiteza	tristeza
utilidade	alegria
primeiranista	medo
desconhece	nojo
batimento	raiva
miudeza	tristeza
faculdades	alegria
principiante	medo
indeferimento	nojo
orgulho	raiva
poupança	tristeza
meios	alegria
bicho do mato	medo
labuta	nojo
altivez	raiva
somiticaria	tristeza
recursos	alegria
insociável	medo
lida	nojo
arrogante	raiva
pão-durismo	tristeza
boa sorte	alegria
misantropo	medo
abafação	nojo
orgulhoso	raiva
tacanhice	tristeza
risco	alegria
solitário	medo
trabalho	nojo
altivo	raiva
desaire	tristeza
chance	alegria
bicho-de-galinha	medo
prego	nojo
rompente	raiva
empecilho	tristeza
bafejo	alegria
belzebu	medo
pregação	nojo
lanço	raiva
regresso	tristeza
futuro	alegria
anjo mau	medo
tráfego	nojo
improvisação	raiva
retornamento	tristeza
fadário	alegria
tinhoso	medo
estafamento	nojo
improviso	raiva
retornança	tristeza
sestro	alegria
lúcifer	medo
maratona	nojo
rasteiro	raiva
retorno	tristeza
mera	alegria
canhoto	medo
trabalheira	nojo
rastejante	raiva
revinda	tristeza
cadeia	alegria
cão	medo
faina	nojo
reptante	raiva
tornada	tristeza
presídio	alegria
chifrudo	medo
lide	nojo
sextilha	raiva
vinda	tristeza
penitenciária	alegria
cornudo	medo
labor	nojo
de repente	raiva
circunferência	tristeza
xilindró	alegria
demônio	medo
lavor	nojo
arroubamento	raiva
borda	tristeza
cárcere	alegria
mafarrico	medo
afazer	nojo
entrada	raiva
circuito	tristeza
xadrez	alegria
maldito	medo
lesco-lesco	nojo
ingresso	raiva
circulação	tristeza
referida	alegria
maligno	medo
lufa-lufa	nojo
admissão	raiva
círculo	tristeza
expressa	alegria
mau	medo
abastamento	nojo
introdução	raiva
contorno	tristeza
exposta	alegria
satã	medo
fartura	nojo
chegada	raiva
giro	tristeza
manda	alegria
satanás	medo
repleção	nojo
aproximação	raiva
pirueta	tristeza
determina	alegria
serpente	medo
saturação	nojo
avizinhação	raiva
redor	tristeza
impõe	alegria
tendeiro	medo
sensaboria	nojo
avizinhamento	raiva
roda	tristeza
estabelece	alegria
tentador	medo
inércia	nojo
abeiramento	raiva
rodada	tristeza
denominada	alegria
agitado	medo
inatividade	nojo
achegamento	raiva
rodeio	tristeza
riqueza	alegria
diabrete	medo
uniformidade	nojo
passagem	raiva
rodopio	tristeza
herança	alegria
irrequieto	medo
invariabilidade	nojo
trânsito	raiva
rotação	tristeza
fazenda	alegria
levado	medo
inalterabilidade	nojo
movimentação	raiva
translação	tristeza
recurso	alegria
traquina	medo
estagnação	nojo
afluência	raiva
passeio	tristeza
bens	alegria
travesso	medo
mesmice	nojo
afluxo	raiva
girata	tristeza
posses	alegria
arguto	medo
rotina	nojo
caminho	raiva
saída	tristeza
acervo	alegria
astucioso	medo
ramerrão	nojo
alcance	raiva
virada	tristeza
algo	alegria
astuto	medo
imobilidade	nojo
obtenção	raiva
viradela	tristeza
liga	alegria
esperto	medo
igualdade	nojo
aquisição	raiva
viragem	tristeza
luxo	alegria
inteligente	medo
unissonância	nojo
possibilidade	raiva
espira	tristeza
fábula	alegria
perspicaz	medo
beberagem	nojo
conexão	raiva
espiral	tristeza
aventura	alegria
sagaz	medo
eletuário	nojo
ligação	raiva
rosca	tristeza
meio	alegria
bodega	medo
elixir	nojo
comunicação	raiva
volteio	tristeza
posse	alegria
diacho	medo
loque	nojo
convivência	raiva
curva	tristeza
natural	alegria
droga	medo
medicamento	nojo
comportamento	raiva
meandro	tristeza
dinheiro	alegria
porcaria	medo
poção	nojo
disponibilidade	raiva
serpeio	tristeza
erva	alegria
caramba	medo
purgante	nojo
crise	raiva
sinuosidade	tristeza
haver	alegria
cáspite	medo
remédio	nojo
acometimento	raiva
tortuosidade	tristeza
vento	alegria
estafermo	medo
tisana	nojo
assomo	raiva
ziguezague	tristeza
chorume	alegria
benzedeira	medo
xaropada	nojo
manifestação	raiva
guinada	tristeza
coco	alegria
necromante	medo
calda	nojo
elevação	raiva
modificação	tristeza
nota	alegria
adivinha	medo
aborrecido	nojo
promoção	raiva
mudança	tristeza
ouro	alegria
feiticeira	medo
aperreador	nojo
subida	raiva
reviravolta	tristeza
patrimônio	alegria
maga	medo
aperreante	nojo
ascensão	raiva
revolução	tristeza
coisas	alegria
mágica	medo
aporrinhante	nojo
ardência	raiva
transformação	tristeza
feito	alegria
nigromante	medo
azucrinante	nojo
ardimento	raiva
viravolta	tristeza
conquista	alegria
vidente	medo
cacete	nojo
brasa	raiva
volta-face	tristeza
troféu	alegria
megera	medo
cansativo	nojo
incêndio	raiva
baque	tristeza
vencimento	alegria
seresma	medo
chato	nojo
tocha	raiva
desar	tristeza
brilharete	alegria
borboleta	medo
desagradável	nojo
calmaria	raiva
desforço	tristeza
brilhantura	alegria
mariposa	medo
enfadonho	nojo
chama	raiva
desforra	tristeza
fato	alegria
panapaná	medo
enfastiante	nojo
labareda	raiva
despique	tristeza
episódio	alegria
bolsa	medo
enjoado	nojo
fogo	raiva
forra	tristeza
caso	alegria
mala	medo
entediante	nojo
efervescência	raiva
reação	tristeza
incidente	alegria
saco	medo
fastidioso	nojo
esto	raiva
réplica	tristeza
peripécia	alegria
meretriz	medo
impertinente	nojo
estuo	raiva
replicação	tristeza
sucedido	alegria
prostituta	medo
implicante	nojo
fogueira	raiva
represália	tristeza
acontecido	alegria
vaca	medo
importuno	nojo
frágua	raiva
resposta	tristeza
resultado	alegria
centopeia	medo
irritante	nojo
inflamação	raiva
revanche	tristeza
desfecho	alegria
cantada	medo
maçador	nojo
mormaço	raiva
revide	tristeza
conclusão	alegria
galanteio	medo
maçante	nojo
soalheira	raiva
saldo	tristeza
desenlace	alegria
sedução	medo
maçudo	nojo
lirismo	raiva
troco	tristeza
decorrência	alegria
conversa	medo
molesto	nojo
fervura	raiva
vindicta	tristeza
fruto	alegria
papo	medo
mortal	nojo
piedade	raiva
restituição	tristeza
repercussão	alegria
lábia	medo
tedioso	nojo
afervoramento	raiva
devolução	tristeza
efeito	alegria
engodo	medo
rivalidade	nojo
devoção	raiva
ressarcimento	tristeza
resulta	alegria
patifaria	medo
guerra	nojo
exuberância	raiva
torna	tristeza
resultância	alegria
canalhice	medo
altercação	nojo
efusão	raiva
laço	tristeza
corolário	alegria
safadeza	medo
batalha	nojo
multiplicidade	raiva
laçada	tristeza
coroamento	alegria
sacanagem	medo
conflito	nojo
religião	raiva
por volta de	tristeza
parto	alegria
velhacaria	medo
contenda	nojo
vitalidade	raiva
batida	tristeza
parição	alegria
velhacagem	medo
disputa	nojo
religiosidade	raiva
percussão	tristeza
apoteose	alegria
velhacada	medo
desarmonia	nojo
aguça	raiva
murro	tristeza
capitólio	alegria
trapaça	medo
desinteligência	nojo
alucinação	raiva
pancada	tristeza
aclamação	alegria
ninharia	medo
divisão	nojo
costume	raiva
soco	tristeza
aplauso	alegria
mixaria	medo
separação	nojo
praxe	raiva
sopapo	tristeza
ovação	alegria
futilidade	medo
cizânia	nojo
hábito	raiva
marca	tristeza
superioridade	alegria
frivolidade	medo
dissensão	nojo
prática	raiva
contusão	tristeza
hegemonia	alegria
ridicularia	medo
dissenso	nojo
uso	raiva
pisadura	tristeza
predominância	alegria
migalhice	medo
caloria	nojo
fixação	raiva
equimose	tristeza
preponderância	alegria
zé-ninguém	medo
quentura	nojo
vezo	raiva
ferida	tristeza
predomínio	alegria
pé-rapado	medo
aquecimento	nojo
artigos	raiva
ferimento	tristeza
prevalência	alegria
insignificante	medo
canícula	nojo
roupas	raiva
hematoma	tristeza
supremacia	alegria
joão-ninguém	medo
calidez	nojo
vestuário	raiva
lesão	tristeza
vantagem	alegria
borra-botas	medo
queimor	nojo
ária	raiva
pisadela	tristeza
império	alegria
pobre-diabo	medo
afeto	nojo
canção	raiva
traumatismo	tristeza
pompa	alegria
homúnculo	medo
afinidade	nojo
cantiga	raiva
talho	tristeza
esplendor	alegria
calhambeque	medo
confraternidade	nojo
modinha	raiva
corte	tristeza
suntuosidade	alegria
cacareco	medo
empatia	nojo
música	raiva
incisão	tristeza
fausto	alegria
bugiganga	medo
estima	nojo
toada	raiva
comoção	tristeza
imponência	alegria
caco	medo
fraternidade	nojo
maior frequência	raiva
chofre	tristeza
enfeite	alegria
tralha	medo
solidariedade	nojo
maioria	raiva
artimanha	tristeza
ornamento	alegria
tareco	medo
afoiteza	nojo
berra	raiva
truque	tristeza
adorno	alegria
traste	medo
denodo	nojo
coqueluche	raiva
ardil	tristeza
ornato	alegria
negócio	medo
desembaraço	nojo
popularidade	raiva
estratagema	tristeza
certeza	alegria
trem	medo
impavidez	nojo
fama	raiva
trama	tristeza
acertamento	alegria
troço	medo
temeridade	nojo
reputação	raiva
desfalque	tristeza
atino	alegria
joça	medo
raça	nojo
renome	raiva
rombo	tristeza
exatidão	alegria
parada	medo
heroísmo	nojo
celebridade	raiva
roubo	tristeza
justeza	alegria
cena	medo
atitude	nojo
divulgação	raiva
amotinação	tristeza
adaptação	alegria
pertences	medo
iniciativa	nojo
publicação	raiva
insurreição	tristeza
ajustado	alegria
objetos	medo
macumba	nojo
difusão	raiva
motim	tristeza
ajustamento	alegria
dragão	medo
destemor	nojo
propagação	raiva
levante	tristeza
combinação	alegria
bofe	medo
bravosidade	nojo
propalação	raiva
motinação	tristeza
conchavo	alegria
maconha	medo
façanha	nojo
ritmo	raiva
putsch	tristeza
contrato	alegria
baseado	medo
proeza	nojo
cadência	raiva
rebelião	tristeza
convenção	alegria
haxixe	medo
pujança	nojo
velocidade	raiva
revolta	tristeza
cabimento	alegria
marijuana	medo
peito	nojo
andamento	raiva
sedição	tristeza
ponderação	alegria
liamba	medo
bizarria	nojo
marcha	raiva
sublevação	tristeza
prudência	alegria
birra	medo
coração	nojo
progresso	raiva
corrente	tristeza
reflexão	alegria
semente	medo
desassombro	nojo
curso	raiva
lufada	tristeza
sabedoria	alegria
caroço	medo
hombridade	nojo
vaga	raiva
rajada	tristeza
sensatez	alegria
cascavel	medo
braço	nojo
cacho	raiva
bicada	tristeza
senso	alegria
víbora	medo
amor-próprio	nojo
ondulação	raiva
golada	tristeza
tino	alegria
estômago	medo
autoestima	nojo
jorro	raiva
gole	tristeza
bom senso	alegria
abdome	medo
dignidade	nojo
torrente	raiva
goleta	tristeza
oportunidade	alegria
abdômen	medo
honra	nojo
barato	raiva
golo	tristeza
propriedade	alegria
bandulho	medo
honradez	nojo
curtição	raiva
hausto	tristeza
ajuste	alegria
barriga	medo
ufania	nojo
fingimento	raiva
pinga	tristeza
regulação	alegria
bojo	medo
pundonor	nojo
dissimulação	raiva
sorvo	tristeza
regulagem	alegria
pança	medo
entono	nojo
falsidade	raiva
tragada	tristeza
cortesias	alegria
panturra	medo
integridade	nojo
artifício	raiva
trago	tristeza
mesuras	alegria
ventre	medo
probidade	nojo
enganação	raiva
aniquilação	tristeza
salamaleques	alegria
desabrimento	medo
moral	nojo
ostentação	raiva
detrimento	tristeza
parabéns	alegria
rudeza	medo
airosidade	nojo
desordem	raiva
dispersão	tristeza
recomendação	alegria
protesto	medo
generosidade	nojo
embrulhada	raiva
debandada	tristeza
rendimento	alegria
mecha	medo
magnanimidade	nojo
rebuliço	raiva
destroço	tristeza
visita	alegria
agredir	medo
prodigalidade	nojo
doidice	raiva
desbaratamento	tristeza
agachados	alegria
desesperação	medo
liberalidade	nojo
doideira	raiva
desbarato	tristeza
embora	alegria
novidade	medo
munificência	nojo
maluquice	raiva
destituição	tristeza
recomendações	alegria
bico	medo
nobreza	nojo
insanidade	raiva
deposição	tristeza
aplicações	alegria
cano	medo
grandeza	nojo
desvario	raiva
retirada	tristeza
resguardo	alegria
entrave	medo
branqueação	nojo
demência	raiva
desbaste	tristeza
agasalho	alegria
inconveniente	medo
alvejamento	nojo
insânia	raiva
percurso	tristeza
bobagem	alegria
questão	medo
branqueamento	nojo
insensatez	raiva
itinerário	tristeza
lazer	alegria
xeque	medo
cora	nojo
imprudência	raiva
rota	tristeza
troça	alegria
desengano	medo
coradouro	nojo
inconsequência	raiva
direção	tristeza
farra	alegria
contraposição	medo
destemer	nojo
irresponsabilidade	raiva
rumo	tristeza
recreio	alegria
contraste	medo
ardidez	nojo
irreflexão	raiva
viagem	tristeza
alívio	alegria
colisão	medo
arreganho	nojo
leviandade	raiva
roteiro	tristeza
orgia	alegria
impasse	medo
inobservância	nojo
excentricidade	raiva
trajetória	tristeza
brincadeira	alegria
sinuca	medo
incúria	nojo
excepcionalidade	raiva
órbita	tristeza
folgança	alegria
bloqueio	medo
confiança	nojo
originalidade	raiva
coincidência	tristeza
folia	alegria
sacrifício	medo
intimidade	nojo
singularidade	raiva
contingência	tristeza
cambalhota	alegria
custo	medo
familiaridade	nojo
esquisitice	raiva
achado	tristeza
folga	alegria
suor	medo
informalidade	nojo
adoração	raiva
tipo	tristeza
brinquedo	alegria
complexidade	medo
intromissão	nojo
idolatria	raiva
espécie	tristeza
desporto	alegria
complexidão	medo
robustez	nojo
fanatismo	raiva
gênero	tristeza
espairecimento	alegria
atrapalhação	medo
fortaleza	nojo
paranoia	raiva
categoria	tristeza
espetáculo	alegria
obscuridade	medo
guapeza	nojo
psicose	raiva
qualidade	tristeza
esporte	alegria
enredamento	medo
possança	nojo
destempero	raiva
classe	tristeza
jogo	alegria
renitência	medo
fígado	nojo
descrença	raiva
variedade	tristeza
programa	alegria
bolada	medo
desentusiasmo	nojo
desperança	raiva
família	tristeza
hobby	alegria
dinheirame	medo
imparcialidade	nojo
abespinhamento	raiva
laia	tristeza
desenfadamento	alegria
aglomeração	medo
sequidão	nojo
agastadura	raiva
ganho	tristeza
entretém	alegria
festival	medo
altruísmo	nojo
embezerramento	raiva
lucro	tristeza
entretimento	alegria
fluxo	medo
desambição	nojo
lua	raiva
proveito	tristeza
bastar	alegria
carregação	medo
omissão	nojo
dada	raiva
condição	tristeza
atender	alegria
alude	medo
desídia	nojo
bruxedo	raiva
posição	tristeza
chegar	alegria
avalancha	medo
livre	nojo
bruxaria	raiva
nível	tristeza
alegrar	alegria
avalanche	medo
vago	nojo
abatido	raiva
parte	tristeza
contentar	alegria
bloco	medo
desocupado	nojo
alquebrado	raiva
quinhão	tristeza
rejubilar	alegria
camada	medo
limpo	nojo
debilitado	raiva
pedaço	tristeza
cumprir	alegria
desperdício	medo
desguarnecido	nojo
langoroso	raiva
cota	tristeza
corresponder	alegria
quantia	medo
desabitado	nojo
caruara	raiva
quota	tristeza
desempenhar	alegria
penca	medo
despovoado	nojo
inconciliabilidade	raiva
fim	tristeza
executar	alegria
feixe	medo
aliviado	nojo
inconformidade	raiva
termo	tristeza
realizar	alegria
magote	medo
derramado	nojo
desconformidade	raiva
final	tristeza
indenizar	alegria
multidão	medo
descarregado	nojo
desencontro	raiva
término	tristeza
liquidar	alegria
montanha	medo
despejado	nojo
desacordo	raiva
remate	tristeza
pagar	alegria
cabedal	medo
entornado	nojo
contradição	raiva
feitiçaria	tristeza
quitar	alegria
caterva	medo
esvaziado	nojo
incongruência	raiva
magia	tristeza
retribuir	alegria
caudal	medo
vazado	nojo
discrepância	raiva
sortilégio	tristeza
saldar	alegria
coleção	medo
carente	nojo
disparidade	raiva
panela	tristeza
solver	alegria
data	medo
destituído	nojo
discordância	raiva
escuro	tristeza
empanturrar	alegria
infinidade	medo
falto	nojo
desequilíbrio	raiva
negridão	tristeza
desforrar-se	alegria
mar	medo
privado	nojo
assimetria	raiva
negror	tristeza
fartar	alegria
porrada	medo
frívolo	nojo
brabeza	raiva
negro	tristeza
mitigar	alegria
dúzia	medo
fútil	nojo
bulha	raiva
escuridade	tristeza
saciar	alegria
estrupício	medo
oco	nojo
duelo	raiva
trevas	tristeza
vingar-se	alegria
imensidão	medo
superficial	nojo
encontro	raiva
pretidão	tristeza
esclarecer	alegria
oceano	medo
tolo	nojo
enfrentamento	raiva
pretume	tristeza
convencer	alegria
caminhão	medo
baldado	nojo
escaramuça	raiva
pretura	tristeza
persuadir	alegria
resma	medo
fracassado	nojo
liça	raiva
manto	tristeza
perfazer	alegria
serra	medo
frustrado	nojo
pega	raiva
sombra	tristeza
obedecer	alegria
lixeira	medo
infrutífero	nojo
peleja	raiva
névoa	tristeza
preencher	alegria
pilha	medo
inútil	nojo
pugilato	raiva
cerração	tristeza
respeitar	alegria
acúmulo	medo
vão	nojo
pugna	raiva
neblina	tristeza
reparar	alegria
floresta	medo
enganoso	nojo
recontro	raiva
nevoeiro	tristeza
suprir	alegria
número	medo
fingido	nojo
requesta	raiva
carranca	tristeza
remediar	alegria
grupo	medo
hipócrita	nojo
sururu	raiva
cenho	tristeza
desagravar	alegria
ajuntamento	medo
mentiroso	nojo
litígio	raiva
sobrecenho	tristeza
sorrir	alegria
cordilheira	medo
buraco	nojo
angu	raiva
tromba	tristeza
condescender	alegria
serrania	medo
espaço	nojo
atrito	raiva
emoção	tristeza
contemporizar	alegria
cabeço	medo
hiato	nojo
bafafá	raiva
vivência	tristeza
transigir	alegria
colina	medo
interrupção	nojo
barulho	raiva
bem-querer	tristeza
permitir	alegria
cômoro	medo
intervalo	nojo
certame	raiva
querença	tristeza
regozijar	alegria
montículo	medo
lacuna	nojo
contenção	raiva
envolvimento	tristeza
deliciar	alegria
morro	medo
vacuidade	nojo
controvérsia	raiva
convicção	tristeza
deleitar	alegria
outeiro	medo
insaciabilidade	nojo
demanda	raiva
intuição	tristeza
divertir	alegria
proeminência	medo
quietação	nojo
desaguisado	raiva
palpite	tristeza
animar	alegria
acumulação	medo
serenidade	nojo
desentendimento	raiva
faro	tristeza
encantar	alegria
reunião	medo
abulia	nojo
discórdia	raiva
bacorejo	tristeza
regalar	alegria
monturo	medo
indolência	nojo
discussão	raiva
presságio	tristeza
distrair	alegria
alto	medo
langor	nojo
dissentimento	raiva
comiseração	tristeza
entreter	alegria
selva	medo
modorra	nojo
frege	raiva
noção	tristeza
enlevar	alegria
frota	medo
ociosidade	nojo
galho	raiva
sentido	tristeza
letificar	alegria
coluna	medo
falecimento	nojo
pendenga	raiva
consciência	tristeza
pascer	alegria
contingente	medo
óbito	nojo
querela	raiva
ideia	tristeza
atrair	alegria
cúmulo	medo
finamento	nojo
rolo	raiva
conceito	tristeza
cativar	alegria
partilha	medo
fenecimento	nojo
rusga	raiva
concepção	tristeza
mimar	alegria
parcela	medo
passamento	nojo
salseiro	raiva
qualidades	tristeza
acarinhar	alegria
saraiva	medo
extinção	nojo
sangangu	raiva
caráter	tristeza
afagar	alegria
chuva	medo
decesso	nojo
testilha	raiva
índole	tristeza
apaixonar-se	alegria
amontoamento	medo
defunção	nojo
competição	raiva
natureza	tristeza
afeiçoar-se	alegria
cardume	medo
libitina	nojo
concorrência	raiva
temperamento	tristeza
enamorar-se	alegria
enxame	medo
traspasse	nojo
cisão	raiva
feitio	tristeza
encantar-se	alegria
pinha	medo
traspassamento	nojo
rompimento	raiva
pêsames	tristeza
gostar	alegria
ruma	medo
exício	nojo
prélio	raiva
condolências	tristeza
destorroar	alegria
braçadeira	medo
desaparecimento	nojo
pendência	raiva
maciez	tristeza
esterroar	alegria
murundu	medo
acabamento	nojo
laboração	raiva
macieza	tristeza
gradar	alegria
imposta	medo
desaparição	nojo
zaragata	raiva
maleabilidade	tristeza
gradear	alegria
dose	medo
ocaso	nojo
debate	raiva
macio	tristeza
leveza	alegria
fração	medo
pena de morte	nojo
desunião	raiva
morosidade	tristeza
bonança	alegria
massa	medo
soldadura	nojo
tenção	raiva
lerdeza	tristeza
equilíbrio	alegria
cópia	medo
soldagem	nojo
apuração	raiva
entorpecimento	tristeza
paz	alegria
superabundância	medo
breu	nojo
apuramento	raiva
soneira	tristeza
quietude	alegria
agrupamento	medo
chona	nojo
derriça	raiva
sono	tristeza
relaxamento	alegria
turba	medo
noitada	nojo
justa	raiva
sonolência	tristeza
remanso	alegria
tanto	medo
pândega	nojo
retesia	raiva
vagar	tristeza
repouso	alegria
aluvião	medo
patuscada	nojo
tendepá	raiva
molícia	tristeza
silêncio	alegria
suma	medo
gandaia	nojo
pane	raiva
fácil	tristeza
sossego	alegria
medida	medo
ignorância	nojo
desarranjo	raiva
simples	tristeza
eutimia	alegria
total	medo
desconhecimento	nojo
deterioração	raiva
descomplicado	tristeza
fleuma	alegria
capacidade	medo
obscurantismo	nojo
danificação	raiva
facilidade	tristeza
imperturbabilidade	alegria
escala	medo
incompreensão	nojo
ruptura	raiva
descomplicação	tristeza
mansidão	alegria
tamanho	medo
incultura	nojo
inutilização	raiva
acessível	tristeza
pacacidade	alegria
dimensão	medo
insipiência	nojo
esfacelo	raiva
canja	tristeza
pacatez	alegria
extensão	medo
insciência	nojo
incorreção	raiva
sopa	tristeza
bafo	alegria
área	medo
vigília	nojo
inexatidão	raiva
caipora	tristeza
mormaceira	alegria
dilúvio	medo
véspera	nojo
irregularidade	raiva
pé	tristeza
consolação	alegria
enchente	medo
cegueira	nojo
disformidade	raiva
inhaca	tristeza
refrigério	alegria
cheia	medo
equilibrar	nojo
distorção	raiva
ziguizira	tristeza
alento	alegria
alagamento	medo
contrabalançar	nojo
má-formação	raiva
ziquizira	tristeza
frescor	alegria
inundação	medo
compensar	nojo
malformação	raiva
burrice	tristeza
auxílio	alegria
ravina	medo
contrapesar	nojo
balda	raiva
bílis	tristeza
consolo	alegria
rio	medo
equiponderar	nojo
pecha	raiva
fubeca	tristeza
lenitivo	alegria
lava	medo
librar	nojo
tinha	raiva
fubecada	tristeza
esperança	alegria
influxo	medo
balançar	nojo
desconcerto	raiva
naufrágio	tristeza
positividade	alegria
enxurro	medo
balancear	nojo
cinca	raiva
academia	tristeza
aprazibilidade	alegria
sucessão	medo
sustentar	nojo
lapso	raiva
cocoroca	tristeza
placidez	alegria
enfiada	medo
suportar	nojo
nequice	raiva
fraca	tristeza
crença	alegria
sequência	medo
suster	nojo
abertura	raiva
sarna	tristeza
mansarrão	alegria
encadeamento	medo
segurar	nojo
brecha	raiva
escabiose	tristeza
normalidade	alegria
firmamento	medo
aguentar	nojo
fenda	raiva
gafeira	tristeza
estabilidade	alegria
cosmos	medo
apoiar	nojo
greta	raiva
catinga	tristeza
regularidade	alegria
universo	medo
amparar	nojo
lasca	raiva
fedor	tristeza
aninho	alegria
globo	medo
escorar	nojo
paráclese	raiva
sereno	tristeza
abraço	alegria
planeta	medo
firmar	nojo
racha	raiva
vagaroso	tristeza
abrigo	alegria
hemisfério	medo
distribuir	nojo
rachadura	raiva
chuvisco	tristeza
acolhimento	alegria
homem	medo
dividir	nojo
janela	raiva
zimbro	tristeza
amparo	alegria
raça humana	medo
subdividir	nojo
falência	raiva
solidão	tristeza
arrimo	alegria
humanidade	medo
partilhar	nojo
ofensiva	raiva
solitude	tristeza
junção	alegria
mortais	medo
repartir	nojo
acometida	raiva
soledade	tristeza
proximidade	alegria
gênero humano	medo
comparticipar	nojo
desestima	raiva
apartamento	tristeza
união	alegria
população	medo
ficar	nojo
desobediência	raiva
insulamento	tristeza
paraíso	alegria
povo	medo
manter-se	nojo
contravenção	raiva
mutismo	tristeza
misticismo	alegria
âmbito	medo
aguentar-se	nojo
descumprimento	raiva
mudez	tristeza
convenientemente	alegria
campo	medo
conter	nojo
incumprimento	raiva
mudeza	tristeza
acertadamente	alegria
esfera	medo
refrear	nojo
azedume	raiva
calada	tristeza
adequadamente	alegria
terreno	medo
deter	nojo
solidez	raiva
incomunicação	tristeza
certo	alegria
bando	medo
domar	nojo
consistência	raiva
atravancamento	tristeza
devidamente	alegria
mundéu	medo
enfrear	nojo
endurecimento	raiva
obstrução	tristeza
corretamente	alegria
soma	medo
travar	nojo
enrijecimento	raiva
alteração	tristeza
satisfatoriamente	alegria
turma	medo
reprimir	nojo
rigidez	raiva
desorganização	tristeza
excelentemente	alegria
casta	medo
sopear	nojo
rijeza	raiva
disfunção	tristeza
direito	alegria
estirpe	medo
qualificar	nojo
austeridade	raiva
jetatura	tristeza
habilmente	alegria
estofa	medo
classificar	nojo
implacabilidade	raiva
inconstância	tristeza
talentosamente	alegria
linhagem	medo
ajuizar	nojo
rispidez	raiva
instabilidade	tristeza
comodamente	alegria
abstergido	medo
julgar	nojo
secura	raiva
variabilidade	tristeza
com saúde	alegria
absterso	medo
pensar	nojo
lisura	raiva
volubilidade	tristeza
em harmonia	alegria
asseado	medo
medir	nojo
pindaíba	raiva
mutabilidade	tristeza
confortavelmente	alegria
dessujo	medo
mensurar	nojo
grosseria	raiva
flutuação	tristeza
em paz	alegria
imaculado	medo
aquilatar	nojo
indelicadeza	raiva
mobilidade	tristeza
claramente	alegria
inconspurcado	medo
aferir	nojo
abrutamento	raiva
variação	tristeza
distintamente	alegria
lavado	medo
reputar	nojo
má-criação	raiva
alternativa	tristeza
exatamente	alegria
mondo	medo
equacionar	nojo
ação	raiva
transmutação	tristeza
justamente	alegria
polido	medo
crer	nojo
grandiosidade	raiva
bicicleta	tristeza
nitidamente	alegria
purificado	medo
investigar	nojo
potência	raiva
bike	tristeza
perfeitamente	alegria
puro	medo
apreçar	nojo
eficácia	raiva
bici	tristeza
precisamente	alegria
aglomerado	medo
taxar	nojo
eficiência	raiva
magrela	tristeza
condignamente	alegria
amontoação	medo
cotar	nojo
prontidão	raiva
magrelinha	tristeza
cortesmente	alegria
conglomerado	medo
regular	nojo
viço	raiva
kalanga	tristeza
educadamente	alegria
conglomeração	medo
determinar	nojo
virtude	raiva
camelo	tristeza
elegantemente	alegria
montoeira	medo
computar	nojo
cometida	raiva
mandinga	tristeza
certamente	alegria
empilhado	medo
contar	nojo
cometimento	raiva
tangolomango	tristeza
provavelmente	alegria
sobreposto	medo
quantificar	nojo
execução	raiva
apesar de	tristeza
seguramente	alegria
agrupado	medo
orçar	nojo
realização	raiva
não obstante	tristeza
assaz	alegria
reunido	medo
esmar	nojo
efetuação	raiva
a despeito de	tristeza
extremamente	alegria
atulhado	medo
suputar	nojo
entrepresa	raiva
independentemente de	tristeza
bondade	alegria
entulhado	medo
prezar	nojo
interpresa	raiva
ainda que	tristeza
ética	alegria
apinhado	medo
adorar	nojo
projeto	raiva
mesmo que	tristeza
amado	alegria
atravancado	medo
amar	nojo
tentame	raiva
sem embargo de	tristeza
querido	alegria
poupado	medo
reverenciar	nojo
tentativa	raiva
conquanto	tristeza
cabedais	alegria
amealhado	medo
cultuar	nojo
empresa	raiva
má vontade	tristeza
haveres	alegria
acumulado	medo
admirar	nojo
entidade	raiva
oferece	tristeza
tesouro	alegria
junto	medo
contemplar	nojo
firma	raiva
destaca	tristeza
ainda bem	alegria
juntado	medo
mirar	nojo
organização	raiva
pacificidade	tristeza
pois bem	alegria
fortemente	medo
fitar	nojo
atuação	raiva
plenidão	tristeza
bem-educado	alegria
profundamente	medo
olhar	nojo
funcionamento	raiva
plenitude	tristeza
bem-posto	alegria
muitíssimo	medo
criticar	nojo
operação	raiva
baixada	tristeza
bem-sucedido	alegria
imensamente	medo
cogitar	nojo
ocupação	raiva
baixos	tristeza
bem-acabado	alegria
descomedidamente	medo
refletir	nojo
emprego	raiva
vale	tristeza
bem-vestido	alegria
grandemente	medo
explorar	nojo
profissão	raiva
decrescimento	tristeza
abastança	alegria
altamente	medo
pesquisar	nojo
ofício	raiva
decréscimo	tristeza
capital	alegria
agudamente	medo
averiguar	nojo
função	raiva
dispensa	tristeza
aumento	alegria
diverso	medo
verificar	nojo
serviço	raiva
demissão	tristeza
crescimento	alegria
vário	medo
sondar	nojo
tarefa	raiva
despedimento	tristeza
desenvolvimento	alegria
numeroso	medo
procurar	nojo
mister	raiva
exclusão	tristeza
melhora	alegria
abundante	medo
perscrutar	nojo
exercício	raiva
rebaixo	tristeza
melhoria	alegria
copioso	medo
perquirir	nojo
desempenho	raiva
degradação	tristeza
clemência	alegria
inúmero	medo
escrutar	nojo
performance	raiva
abjeção	tristeza
filantropia	alegria
diferente	medo
escrutinar	nojo
roda-viva	raiva
capachismo	tristeza
beneficência	alegria
variado	medo
ver	nojo
presteza	raiva
humildade	tristeza
atravanco	alegria
profuso	medo
ler	nojo
rapidez	raiva
mediocridade	tristeza
barranco	alegria
farto	medo
vasculhar	nojo
indústria	raiva
precariedade	tristeza
barreira	alegria
múltiplo	medo
esgravatar	nojo
pró-atividade	raiva
atraso	tristeza
busílis	alegria
excessivo	medo
escarafunchar	nojo
afincamento	raiva
subdesenvolvimento	tristeza
cadeado	alegria
exagerado	medo
comentar	nojo
caturrice	raiva
impotência	tristeza
embargo	alegria
exorbitante	medo
decompor	nojo
obcecação	raiva
atenuação	tristeza
empacho	alegria
superabundante	medo
dissecar	nojo
perrice	raiva
remissão	tristeza
empata	alegria
intenso	medo
esmiuçar	nojo
teima	raiva
atrofia	tristeza
empeço	alegria
sobejo	medo
esquadrinhar	nojo
teimosice	raiva
declinação	tristeza
empeno	alegria
nímio	medo
minuciar	nojo
turra	raiva
emagrecimento	tristeza
encalhe	alegria
grande	medo
psicanalisar	nojo
acinte	raiva
esvaecimento	tristeza
encravo	alegria
deveras	medo
achar	nojo
suposição	raiva
mitigação	tristeza
encrenca	alegria
sobremaneira	medo
acreditar	nojo
imaginação	raiva
eclipse	tristeza
estorva	alegria
sobremodo	medo
sentir	nojo
congeminação	raiva
precarização	tristeza
gargalo	alegria
assustadoramente	medo
conceituar	nojo
discriminação	raiva
descida	tristeza
imbondo	alegria
indefinidamente	medo
meditar	nojo
dissidência	raiva
ágio	tristeza
intercepção	alegria
extraordinariamente	medo
matutar	nojo
preconceito	raiva
comissão	tristeza
interdição	alegria
repetidamente	medo
raciocinar	nojo
reincidência	raiva
retenção	tristeza
mas	alegria
frequentemente	medo
cuidar	nojo
grilo	raiva
défice	tristeza
nó	alegria
sempre	medo
discorrer	nojo
revelia	raiva
sensualidade	tristeza
pespego	alegria
amiúde	medo
reflexionar	nojo
contempla	raiva
analdia	tristeza
pior	alegria
abundantemente	medo
elucubrar	nojo
implica	raiva
ignorante	tristeza
porém	alegria
em quantidade	medo
lucubrar	nojo
reflete	raiva
estulto	tristeza
prisão	alegria
nenhum	medo
ter em conta	nojo
remói	raiva
idiota	tristeza
proibição	alegria
qualquer	medo
levar em conta	nojo
emulação	raiva
imbecil	tristeza
remora	alegria
maior	medo
atentar	nojo
nadinha	raiva
inepto	tristeza
restrição	alegria
assim	medo
interessar-se	nojo
pouquinho	raiva
lerdaço	tristeza
tolhimento	alegria
excepcional	medo
honrar	nojo
idiossincrasia	raiva
néscio	tristeza
tope	alegria
atípico	medo
valorizar	nojo
desmazelo	raiva
parvo	tristeza
torniquete	alegria
incomum	medo
acatar	nojo
inadvertência	raiva
pateta	tristeza
trambolho	alegria
inesperado	medo
conceber	nojo
frigidez	raiva
apalermado	tristeza
vedação	alegria
inusitado	medo
pressupor	nojo
gelo	raiva
aparvalhado	tristeza
milagre	alegria
raro	medo
tomar	nojo
algidez	raiva
louco	tristeza
deslumbramento	alegria
extraordinário	medo
conjeturar	nojo
frialdade	raiva
maluco	tristeza
maravilhamento	alegria
singular	medo
especular	nojo
distância	raiva
bobo	tristeza
impecabilidade	alegria
grande parte de	medo
simpatizar	nojo
neutralidade	raiva
trouxa	tristeza
calêndula	alegria
muito bom	medo
apegar-se	nojo
frio	raiva
raso	tristeza
glorificação	alegria
satisfatório	medo
benquerer	nojo
calo	raiva
lambão	tristeza
vaidade	alegria
suficiente	medo
contabilizar	nojo
friúra	raiva
otário	tristeza
presunção	alegria
suficientemente	medo
estabelecer	nojo
regelo	raiva
tantã	tristeza
deificação	alegria
excepcionalmente	medo
antever	nojo
mármore	raiva
tonto	tristeza
divinização	alegria
imensurável	medo
entrever	nojo
neve	raiva
peco	tristeza
idealização	alegria
desmesurado	medo
desejar	nojo
escárnio	raiva
desajeitado	tristeza
transportação	alegria
ilimitado	medo
regozijar-se	nojo
desprestígio	raiva
arara	tristeza
deslocamento	alegria
incalculável	medo
contentar-se	nojo
malbarato	raiva
atoleimado	tristeza
deslocação	alegria
incomensurável	medo
alegrar-se	nojo
apoucamento	raiva
babaquara	tristeza
condução	alegria
incontável	medo
sobre-estimar	nojo
desabono	raiva
banana	tristeza
porte	alegria
infindo	medo
aprender	nojo
desacatamento	raiva
basbaque	tristeza
translado	alegria
infinito	medo
educar-se	nojo
descortesia	raiva
beócio	tristeza
traslado	alegria
agigantado	medo
entender	nojo
desveneração	raiva
bestalhão	tristeza
locomoção	alegria
ingente	medo
ilustrar-se	nojo
insubordinação	raiva
boboca	tristeza
locomobilidade	alegria
mastodôntico	medo
instruir-se	nojo
irrespeito	raiva
leso	tristeza
veículo	alegria
monstruoso	medo
preparar-se	nojo
irreverência	raiva
paspalho	tristeza
viatura	alegria
paquidérmico	medo
compreender	nojo
profanação	raiva
tatibitate	tristeza
carro	alegria
amplo	medo
consultar	nojo
blasfêmia	raiva
zebroide	tristeza
transportamento	alegria
espaçoso	medo
decorar	nojo
desafio	raiva
avoado	tristeza
transferência	alegria
extenso	medo
gravar	nojo
escândalo	raiva
coió	tristeza
transposição	alegria
vasto	medo
guardar	nojo
xingamento	raiva
microcéfalo	tristeza
transcrição	alegria
profundo	medo
memorizar	nojo
desvalimento	raiva
papelão	tristeza
revelação	alegria
complexo	medo
ensaiar	nojo
desafeto	raiva
mocó	tristeza
exibição	alegria
considerável	medo
exercitar	nojo
largueza	raiva
luca	tristeza
exteriorização	alegria
espantoso	medo
praticar	nojo
longanimidade	raiva
panaca	tristeza
demonstração	alegria
fabuloso	medo
treinar	nojo
modéstia	raiva
trepidação	tristeza
bebedeira	alegria
fantástico	medo
vigiar	nojo
emissão	raiva
estremecimento	tristeza
pileque	alegria
fenomenal	medo
debater	nojo
abandonamento	raiva
balanço	tristeza
porre	alegria
formidável	medo
discutir	nojo
deserção	raiva
sacudida	tristeza
ebriedade	alegria
forte	medo
indagar	nojo
evacuação	raiva
sacudidela	tristeza
pua	alegria
maravilhoso	medo
planejar	nojo
fuga	raiva
abalamento	tristeza
peludo	alegria
em excesso	medo
simular	nojo
partida	raiva
estremeção	tristeza
porco	alegria
em demasia	medo
tratar	nojo
abdicação	raiva
frêmito	tristeza
água	alegria
além da conta	medo
versar	nojo
cessão	raiva
abalada	tristeza
camoeca	alegria
além da medida	medo
ir	nojo
desistência	raiva
tranco	tristeza
cana	alegria
além disso	medo
cursar	nojo
entrega	raiva
moção	tristeza
gata	alegria
além desse fato	medo
fazer	nojo
humanitarismo	raiva
desinquietação	tristeza
piteira	alegria
além do mais	medo
seguir	nojo
alheação	raiva
dissuasão	tristeza
vinho	alegria
além de que	medo
aprofundar	nojo
ausência	raiva
terremoto	tristeza
ganso	alegria
ademais	medo
escabichar	nojo
digressão	raiva
sismo	tristeza
despacho	alegria
de mais a mais	medo
espiolhar	nojo
divagação	raiva
tombo	tristeza
necromancia	alegria
aliás	medo
testar	nojo
abstração	raiva
caída	tristeza
nigromancia	alegria
outros	medo
provar	nojo
excurso	raiva
abismo	tristeza
atrativo	alegria
restantes	medo
inspecionar	nojo
lamentação	raiva
eversão	tristeza
formosura	alegria
resto	medo
interrogar	nojo
lamento	raiva
derriço	tristeza
magnetismo	alegria
mais	medo
questionar	nojo
lamúria	raiva
embeiçamento	tristeza
fascinação	alegria
exuberante	medo
revistar	nojo
queixume	raiva
rabicho	tristeza
liame	alegria
excedente	medo
vistoriar	nojo
gemido	raiva
inferioridade	tristeza
vínculo	alegria
hiperbólico	medo
fixar	nojo
ai	raiva
vulgaridade	tristeza
encabulação	alegria
abusivo	medo
assistir	nojo
pranto	raiva
torpeza	tristeza
contração	alegria
por demais	medo
presenciar	nojo
suspiro	raiva
sujeira	tristeza
voejo	alegria
supérfluo	medo
testemunhar	nojo
melúria	raiva
lama	tristeza
adejo	alegria
desnecessário	medo
constatar	nojo
jeremiada	raiva
lodo	tristeza
caminhada	alegria
dispensável	medo
notar	nojo
murmúrio	raiva
chulice	tristeza
andança	alegria
prescindível	medo
perceber	nojo
reclamação	raiva
futricagem	tristeza
passo	alegria
escusado	medo
espiar	nojo
protestação	raiva
sabujice	tristeza
invernada	alegria
redundante	medo
espreitar	nojo
reivindicação	raiva
turpitude	tristeza
engorda	alegria
desregrado	medo
espionar	nojo
denúncia	raiva
cafajestada	tristeza
alimento	alegria
descontrolado	medo
bisbilhotar	nojo
participação	raiva
suja	tristeza
comida	alegria
descomedido	medo
descobrir	nojo
acusação	raiva
letargo	tristeza
alimentação	alegria
imoderado	medo
advertir	nojo
delação	raiva
adormecimento	tristeza
assunto	alegria
incontrolável	medo
repreender	nojo
incriminação	raiva
sopor	tristeza
pastagem	alegria
sobreposse	medo
censurar	nojo
criminação	raiva
apodrecimento	tristeza
tema	alegria
sobejamente	medo
admoestar	nojo
inculpação	raiva
putrefação	tristeza
prado	alegria
imoderadamente	medo
prevenir	nojo
imputação	raiva
depredação	tristeza
ervaçal	alegria
fartamente	medo
replicar	nojo
libelo	raiva
massacre	tristeza
forragem	alegria
profusamente	medo
expressar	nojo
crítica	raiva
exterminação	tristeza
sorriso	alegria
verdadeiramente	medo
exprimir	nojo
exprobação	raiva
extermínio	tristeza
zombaria	alegria
totalmente	medo
avisar	nojo
sintoma	raiva
chacina	tristeza
gargalhada	alegria
surpreendentemente	medo
lembrar	nojo
bile	raiva
mortandade	tristeza
gozação	alegria
eminentemente	medo
observar-se	nojo
suscetibilidade	raiva
gasto	tristeza
chacota	alegria
elevadamente	medo
cismar	nojo
afetação	raiva
despesa	tristeza
ridículo	alegria
seriamente	medo
ruminar	nojo
pedantismo	raiva
dispêndio	tristeza
hilaridade	alegria
acatamento	medo
alegar	nojo
dengue	raiva
dissipação	tristeza
risada	alegria
atendimento	medo
argumentar	nojo
história	raiva
esbanjamento	tristeza
relevância	alegria
observação	medo
mencionar	nojo
susceptibilidade	raiva
malbaratamento	tristeza
valia	alegria
submissão	medo
citar	nojo
besteira	raiva
fosso	tristeza
magnitude	alegria
subordinação	medo
pretextar	nojo
capanga	raiva
concavidade	tristeza
vulto	alegria
relação	medo
justificar	nojo
denguice	raiva
algar	tristeza
monta	alegria
referência	medo
expor	nojo
dengo	raiva
antro	tristeza
préstimo	alegria
aspecto	medo
arguir	nojo
amassado	raiva
catacumba	tristeza
curiosidade	alegria
perspectiva	medo
arrazoar	nojo
amassadela	raiva
caverna	tristeza
egoísmo	alegria
ângulo	medo
suspeitar	nojo
amassadura	raiva
cavidade	tristeza
individualismo	alegria
lado	medo
envaidecer-se	nojo
amolgadela	raiva
cova	tristeza
egocentrismo	alegria
motivo	medo
gloriar-se	nojo
amolgadura	raiva
covil	tristeza
juro	alegria
ponto de vista	medo
jactar-se	nojo
amolgamento	raiva
furna	tristeza
dividendo	alegria
prisma	medo
orgulhar-se	nojo
impressão	raiva
gruta	tristeza
galardão	alegria
homenagens	medo
ufanar-se	nojo
entalhe	raiva
lapa	tristeza
existência	alegria
saudações	medo
vangloriar-se	nojo
entalho	raiva
cava	tristeza
presença	alegria
a respeito de	medo
desconfiar	nojo
entalha	raiva
esfriamento	tristeza
época	alegria
a respeito	medo
duvidar	nojo
entalhamento	raiva
resfriamento	tristeza
fase	alegria
no que diz respeito	medo
criar	nojo
entalhadura	raiva
refrigeração	tristeza
idade	alegria
diz respeito	medo
fantasiar	nojo
indício	raiva
corrosão	tristeza
motivação	alegria
dizer respeito a	medo
sonhar	nojo
ranço	raiva
esfacelamento	tristeza
relato	alegria
no que diz respeito a	medo
idealizar	nojo
vestígio	raiva
consumo	tristeza
biografia	alegria
bagunça	medo
inventar	nojo
aspirar	raiva
consumpção	tristeza
memórias	alegria
roldão	medo
idear	nojo
ansiar	raiva
atrição	tristeza
fauna	alegria
nervosismo	medo
elaborar	nojo
almejar	raiva
erosão	tristeza
flora	alegria
ralação	medo
projetar	nojo
ambicionar	raiva
ablação	tristeza
começo	alegria
nervoso	medo
traçar	nojo
cobiçar	raiva
esgotadura	tristeza
causa	alegria
tempestade	medo
prognosticar	nojo
apetecer	raiva
esgoto	tristeza
início	alegria
prurido	medo
concluir	nojo
esperar	raiva
empobrecimento	tristeza
origem	alegria
chamego	medo
atinar	nojo
anelar	raiva
despejo	tristeza
passadio	alegria
fervedouro	medo
identificar	nojo
pretender	raiva
secagem	tristeza
subsistência	alegria
turbação	medo
saber	nojo
tencionar	raiva
enxugamento	tristeza
sustento	alegria
formigueiro	medo
deduzir	nojo
intencionar	raiva
drenagem	tristeza
espírito	alegria
quebra-cabeça	medo
confiar	nojo
intentar	raiva
inação	tristeza
ser	alegria
quebra-cabeças	medo
aprontar	nojo
planear	raiva
lassitude	tristeza
substância	alegria
dor de cabeça	medo
armar	nojo
exigir	raiva
dormência	tristeza
alicerce	alegria
visão	medo
organizar	nojo
ordenar	raiva
formigamento	tristeza
base	alegria
fantasma	medo
preparar	nojo
mandar	raiva
dissolução	tristeza
fundamento	alegria
aparição	medo
admitir	nojo
obrigar	raiva
eliminação	tristeza
pilar	alegria
tremido	medo
depreender	nojo
impor	raiva
liquidação	tristeza
suporte	alegria
vibração	medo
inferir	nojo
demandar	raiva
niilismo	tristeza
sustentação	alegria
arrepio	medo
interrogar-se	nojo
requerer	raiva
remoção	tristeza
sustentáculo	alegria
calafrio	medo
predizer	nojo
necessitar	raiva
esmagamento	tristeza
qualidade de vida	alegria
horripilação	medo
pressagiar	nojo
precisar	raiva
pulverização	tristeza
agraço	alegria
balismo	medo
pressentir	nojo
carecer	raiva
genocídio	tristeza
luxúria	alegria
palpitação	medo
vaticinar	nojo
preferir	raiva
subversão	tristeza
verde	alegria
tremedeira	medo
adivinhar	nojo
optar	raiva
descaída	tristeza
verdor	alegria
trêmulo	medo
prenunciar	nojo
eleger	raiva
pachorra	tristeza
verdura	alegria
assiduidade	medo
augurar	nojo
decidir-se	raiva
paralisação	tristeza
vicejo	alegria
fidelidade	medo
agourar	nojo
selecionar	raiva
paralisia	tristeza
validade	alegria
atilamento	medo
agoirar	nojo
escolher	raiva
emaciação	tristeza
vigência	alegria
exação	medo
futurar	nojo
dispor-se	raiva
morbidade	tristeza
ênfase	alegria
empenhamento	medo
antecipar	nojo
oferecer-se	raiva
fragmentação	tristeza
talismã	alegria
insistência	medo
profetizar	nojo
prestar-se	raiva
fratura	tristeza
ofuscação	alegria
pertinácia	medo
subentender	nojo
venerar	raiva
fracionamento	tristeza
dança	alegria
porfia	medo
aceitar	nojo
idolatrar	raiva
partição	tristeza
corre-corre	alegria
notoriedade	medo
atribuir	nojo
consentir	raiva
quebradura	tristeza
turbilhão	alegria
pistolão	medo
acusar	nojo
autorizar	raiva
desagregação	tristeza
vendaval	alegria
cartucho	medo
condenar	nojo
deixar	raiva
descontinuação	tristeza
polvorosa	alegria
mediação	medo
culpabilizar	nojo
concordar	raiva
paragem	tristeza
algazarra	alegria
cunha	medo
imputar	nojo
conceder	raiva
intermissão	tristeza
bulício	alegria
penhora	medo
incriminar	nojo
anuir	raiva
cessação	tristeza
caos	alegria
penhor	medo
inculpar	nojo
benquerença	raiva
rescisão	tristeza
conturbação	alegria
hipoteca	medo
responsabilizar	nojo
objetivo	raiva
bancarrota	tristeza
ebulição	alegria
comprometimento	medo
manipular	nojo
sem querer	raiva
falimento	tristeza
burburinho	alegria
promessa	medo
levar	nojo
hipertermia	raiva
insolvência	tristeza
deus nos acuda	alegria
engajamento	medo
inspirar	nojo
pirexia	raiva
dobra	tristeza
ápice	alegria
imaleabilidade	medo
interferir	nojo
temperatura	raiva
dobradura	tristeza
faísca	alegria
retidão	medo
controlar	nojo
febre intermitente	raiva
prega	tristeza
fagulha	alegria
circunspecção	medo
agir	nojo
impaludismo	raiva
vinco	tristeza
chispa	alegria
crimeza	medo
dominar	nojo
malária	raiva
ruga	tristeza
faúlha	alegria
seriedade	medo
obrar	nojo
maleita	raiva
meneio	tristeza
corisco	alegria
sisudez	medo
operar	nojo
paludismo	raiva
requebro	tristeza
luz	alegria
cautela	medo
empreender	nojo
sezão	raiva
bamboleio	tristeza
epifania	alegria
circunspeção	medo
mover-se	nojo
sezões	raiva
saracoteio	tristeza
insight	alegria
precaução	medo
lidar	nojo
sezonismo	raiva
declive	tristeza
clarão	alegria
tento	medo
trabalhar	nojo
metrópole	raiva
rampa	tristeza
brilho	alegria
conta	medo
concretizar	nojo
matriz	raiva
vertente	tristeza
fulgor	alegria
aprimorado	medo
representar	nojo
mãe	raiva
encosta	tristeza
cintilação	alegria
caprichado	medo
interpretar	nojo
central	raiva
lomba	tristeza
fulguração	alegria
esmerado	medo
encenar	nojo
centro	raiva
costado	tristeza
luzeiro	alegria
impecável	medo
encarnar	nojo
núcleo	raiva
quebrada	tristeza
revérbero	alegria
perfeito	medo
funcionar	nojo
cerne	raiva
quebrado	tristeza
lume	alegria
primoroso	medo
exercer	nojo
foco	raiva
sobras	tristeza
cio	alegria
meditado	medo
ocupar-se	nojo
seio	raiva
restos	tristeza
plectro	alegria
pensado	medo
encarregar-se	nojo
polo	raiva
embigo	tristeza
verve	alegria
ponderado	medo
proceder	nojo
catedral	raiva
protuberância	tristeza
poesia	alegria
previdência	medo
contribuir	nojo
sé	raiva
saliência	tristeza
musa	alegria
refletido	medo
colaborar	nojo
igreja	raiva
ponto central	tristeza
toque	alegria
calculado	medo
facilitar	nojo
domo	raiva
ponto de convergência	tristeza
lira	alegria
esperado	medo
favorecer	nojo
assento	raiva
ponto nuclear	tristeza
descoberta	alegria
previsto	medo
concorrer	nojo
cadeira	raiva
encolhimento	tristeza
nitidez	alegria
proposital	medo
auxiliar	nojo
banco	raiva
encurtamento	tristeza
luzerna	alegria
intencional	medo
valer	nojo
libidinagem	raiva
estreitamento	tristeza
luzimento	alegria
propositado	medo
coagir	nojo
pimenta	raiva
limitação	tristeza
hálito	alegria
premeditado	medo
constranger	nojo
sexo	raiva
merma	tristeza
brisa	alegria
deliberado	medo
forçar	nojo
umidade	raiva
minguamento	tristeza
aragem	alegria
queda-d'água	medo
intimidar	nojo
sexualidade	raiva
minoração	tristeza
viração	alegria
cachoeira	medo
tutear	nojo
imaginativa	raiva
moderação	tristeza
anélito	alegria
cascata	medo
compelir	nojo
criatividade	raiva
restringimento	tristeza
fôlego	alegria
transição	medo
aliciar	nojo
inventividade	raiva
lembranças	tristeza
folgo	alegria
cabriola	medo
aconselhar	nojo
criação	raiva
respeitos	tristeza
respiração	alegria
pincho	medo
conduzir	nojo
invenção	raiva
escabiosa	tristeza
ar	alegria
pinote	medo
encorajar	nojo
faz-de-conta	raiva
flor-de-viúva	tristeza
aura	alegria
pulo	medo
impelir	nojo
ficção	raiva
saudades	tristeza
bocejo	alegria
bote	medo
impulsionar	nojo
ilusão	raiva
suspiros	tristeza
som	alegria
catarata	medo
incentivar	nojo
quimera	raiva
viúva	tristeza
bufo	alegria
passada	medo
incitar	nojo
utopia	raiva
viúvas	tristeza
incorporação	alegria
corcovo	medo
seduzir	nojo
bijuteria	raiva
chibante	tristeza
característica	alegria
tacão	medo
suscitar	nojo
energia vital	raiva
feiticeiro	tristeza
cunho	alegria
repentino	medo
incutir	nojo
finalidade	raiva
tijuca	tristeza
peculiaridade	alegria
aparato	medo
formular	nojo
plano	raiva
banzeiro	tristeza
teor	alegria
gritaria	medo
cobrir	nojo
aplicado	raiva
admirado	tristeza
tom	alegria
berreiro	medo
emboçar	nojo
atento	raiva
amofinado	tristeza
comicidade	alegria
calvície	medo
guarnecer	nojo
dedicado	raiva
amolado	tristeza
humor	alegria
alopecia	medo
indutar	nojo
esforçado	raiva
pasmado	tristeza
jocosidade	alegria
premonição	medo
revestir	nojo
escopo	raiva
triste	tristeza
identidade	alegria
presciência	medo
transmitir	nojo
alvo	raiva
ceticismo	tristeza
pessoa agradável	alegria
previsão	medo
comunicar	nojo
fito	raiva
pessimismo	tristeza
ritual	alegria
divinação	medo
condicionar	nojo
meta	raiva
cepticismo	tristeza
caidela	alegria
feeling	medo
imprimir	nojo
objeto	raiva
descômodo	tristeza
boléu	alegria
hipótese	medo
infundir	nojo
vista	raiva
descomodidade	tristeza
trambolhão	alegria
conjectura	medo
insinuar	nojo
mira	raiva
incomodidade	tristeza
catadupa	alegria
pressuposto	medo
instilar	nojo
impertinência	raiva
engasgo	tristeza
cachão	alegria
questionável	medo
insuflar	nojo
aprimoramento	raiva
abafamento	tristeza
decaída	alegria
contestável	medo
sugerir	nojo
timbre	raiva
abafo	tristeza
desabamento	alegria
discutível	medo
alentar	nojo
pensamento	raiva
apneia	tristeza
desmoronamento	alegria
suspicaz	medo
entusiasmar	nojo
lenda	raiva
asfixia	tristeza
outono	alegria
inquietante	medo
estimular	nojo
mito	raiva
afogo	tristeza
atraimento	alegria
arquejamento	medo
excitar	nojo
mitologia	raiva
sacrilégio	tristeza
enfraquecido	alegria
arfagem	medo
inflamar	nojo
cacoete	raiva
perversão	tristeza
débil	alegria
latejo	medo
importar	nojo
jeitão	raiva
impacto	tristeza
fracote	alegria
piada	medo
interessar	nojo
bizarrice	raiva
machucado	tristeza
doente	alegria
rouquidão	medo
aplicar-se	nojo
estapafurdismo	raiva
faniquito	tristeza
adoentado	alegria
paroxismo	medo
dedicar-se	nojo
exotismo	raiva
chilique	tristeza
franzino	alegria
pressão	medo
devotar-se	nojo
ratada	raiva
esmaecimento	tristeza
anêmico	alegria
voto	medo
entregar-se	nojo
ratice	raiva
lipotimia	tristeza
acabadiço	alegria
almejo	medo
concitar	nojo
maluqueira	raiva
apsiquia	tristeza
lânguido	alegria
desiderato	medo
desafiar	nojo
monomania	raiva
fanico	tristeza
despreparado	alegria
espero	medo
fomentar	nojo
obumbração	raiva
arrelia	tristeza
incompetente	alegria
dilema	medo
acicatar	nojo
telha	raiva
cacetada	tristeza
incapaz	alegria
questionamento	medo
acirrar	nojo
cachaça	raiva
caceteação	tristeza
inábil	alegria
ambivalência	medo
açodar	nojo
vesânia	raiva
chateza	tristeza
inferior	alegria
anfibolia	medo
açular	nojo
ideal	raiva
chatura	tristeza
imperfeito	alegria
anfibologia	medo
assanhar	nojo
idealidade	raiva
maçadoria	tristeza
péssimo	alegria
dubieza	medo
atiçar	nojo
boniteza	raiva
extravio	tristeza
ruim	alegria
perplexão	medo
despertar	nojo
lindeza	raiva
descaminho	tristeza
insuficiente	alegria
titubeação	medo
espicaçar	nojo
manha	raiva
sumiço	tristeza
mediano	alegria
titubeio	medo
interceder	nojo
batalhação	raiva
cancelamento	tristeza
medíocre	alegria
desvalor	medo
intrometer-se	nojo
contumácia	raiva
supressão	tristeza
ralo	alegria
poltroneria	medo
imiscuir-se	nojo
instância	raiva
arrasamento	tristeza
suave	alegria
cintilante	medo
ingerir-se	nojo
rebeldia	raiva
arruinação	tristeza
tênue	alegria
cintilar	medo
mexer	nojo
recalcitrância	raiva
arruinamento	tristeza
ameno	alegria
faiscante	medo
meter-se	nojo
rasgão	raiva
perdição	tristeza
frágil	alegria
faiscar	medo
enxerir-se	nojo
rasgadura	raiva
pontapé	tristeza
delicado	alegria
fulgurar	medo
opinar	nojo
traço	raiva
amuamento	tristeza
fino	alegria
frescura	medo
dizer	nojo
linha	raiva
calundu	tristeza
quebradiço	alegria
efemeridade	medo
falar	nojo
encaixe	raiva
acidez	tristeza
quebrável	alegria
impermanência	medo
manifestar	nojo
estria	raiva
conjuntura	tristeza
brando	alegria
perecibilidade	medo
deliberar	nojo
expediente	raiva
acrimônia	tristeza
manso	alegria
transitoriedade	medo
gerir	nojo
farpa	raiva
agror	tristeza
tolerante	alegria
estiolamento	medo
dirigir	nojo
tirada	raiva
escabrosidade	tristeza
transigente	alegria
atrofiamento	medo
manobrar	nojo
pitaco	raiva
desaponto	tristeza
condescendente	alegria
héctica	medo
comandar	nojo
sugestão	raiva
metanoia	tristeza
flexível	alegria
tísica	medo
imperar	nojo
conselho	raiva
pungimento	tristeza
permissivo	alegria
hética	medo
participar	nojo
julgamento	raiva
reconsideração	tristeza
moderado	alegria
esfalfação	medo
comparecer	nojo
parecer	raiva
afligir	tristeza
comedido	alegria
esfalfe	medo
suceder	nojo
proposta	raiva
atribular	tristeza
covarde	alegria
irritabilidade	medo
sobrevir	nojo
dispor	raiva
agoniar	tristeza
cobarde	alegria
pudicícia	medo
acontecer	nojo
alvitramento	raiva
expiar	tristeza
medroso	alegria
tepidez	medo
ocorrer	nojo
aposta	raiva
resgatar	tristeza
temeroso	alegria
acanho	medo
irromper	nojo
anterioridade	raiva
padecer	tristeza
receoso	alegria
bisonharia	medo
prorromper	nojo
antecedência	raiva
sofrer	tristeza
assustado	alegria
bisonhice	medo
desatar	nojo
primado	raiva
pastar	tristeza
assustadiço	alegria
encalistração	medo
explodir	nojo
principalidade	raiva
morrer	tristeza
pusilânime	alegria
encalistramento	medo
estourar	nojo
prioridade	raiva
saborear	tristeza
tímido	alegria
encolha	medo
surgir	nojo
privilégio	raiva
confirmação	tristeza
timorato	alegria
inibição	medo
gerar	nojo
excelência	raiva
comprovação	tristeza
espantado	alegria
depravação	medo
produzir	nojo
competência	raiva
evidência	tristeza
espantadiço	alegria
escória	medo
aguçar	nojo
sublimidade	raiva
testemunho	tristeza
mofino	alegria
borrão	medo
avivar	nojo
preeminência	raiva
indicação	tristeza
pávido	alegria
estigma	medo
exortar	nojo
benquerança	raiva
mostra	tristeza
poltrão	alegria
jaça	medo
instar	nojo
culto	raiva
exame	tristeza
parco	alegria
poluição	medo
promover	nojo
estusiasmo	raiva
avaliação	tristeza
escasso	alegria
nódoa	medo
reavivar	nojo
namoro	raiva
teste	tristeza
limitado	alegria
trinca	medo
vivificar	nojo
relacionamento	raiva
verificação	tristeza
minguado	alegria
inexistência	medo
conquistar	nojo
romance	raiva
concurso	tristeza
pequeno	alegria
insuficiência	medo
envolver	nojo
acasalamento	raiva
torneio	tristeza
reduzido	alegria
pouquidade	medo
prender	nojo
ato sexual	raiva
ensaio	tristeza
diminuto	alegria
exiguidade	medo
alicerçar	nojo
coito	raiva
experiência	tristeza
ligeiro	alegria
desacerto	medo
basear	nojo
cópula	raiva
experimento	tristeza
irrisório	alegria
prevaricação	medo
declarar	nojo
copulação	raiva
degustação	tristeza
miúdo	alegria
trivialidade	medo
explicar	nojo
amante	raiva
provadura	tristeza
mole	alegria
pleonasmo	medo
fundamentar	nojo
garoto	raiva
curvatura	tristeza
frouxo	alegria
nada	medo
respaldar	nojo
mina	raiva
mendicância	tristeza
flácido	alegria
inocuidade	medo
imbuir	nojo
namorado	raiva
mendicidade	tristeza
fofo	alegria
desnecessidade	medo
impressionar	nojo
xodó	raiva
pauperismo	tristeza
tenro	alegria
ponto	medo
governar	nojo
hanseníase	raiva
paupérie	tristeza
indeciso	alegria
erupção	medo
cantar	nojo
lepra	raiva
carestia	tristeza
