	0
alegria	alegria
tristeza	tristeza
raiva	raiva
nojo	nojo
medo	medo
animação	alegria
alacridade	alegria
agrado	alegria
felicidade	alegria
prazer	alegria
aprazimento	alegria
euforia	alegria
bem-estar	alegria
bom humor	alegria
comprazimento	alegria
contentamento	alegria
contento	alegria
deleitação	alegria
deleitamento	alegria
deleite	alegria
desfastio	alegria
enlevo	alegria
entusiasmo	alegria
gáudio	alegria
gosto	alegria
gozo	alegria
jovialidade	alegria
jubilação	alegria
júbilo	alegria
jucundidade	alegria
ledice	alegria
pasto	alegria
regalo	alegria
regozijo	alegria
riso	alegria
satisfação	alegria
glória	alegria
festa	alegria
divertimento	alegria
diversão	alegria
distração	alegria
entretenimento	alegria
farra	alegria
folguedo	alegria
recreação	alegria
infelicidade	tristeza
desânimo	tristeza
tristura	tristeza
descontentamento	tristeza
abatimento	tristeza
melancolia	tristeza
desalento	tristeza
desolação	tristeza
desconsolo	tristeza
insatisfação	tristeza
esmorecimento	tristeza
prostração	tristeza
depressão	tristeza
desesperança	tristeza
mágoa	tristeza
desgosto	tristeza
sofrimento	tristeza
aflição	tristeza
angústia	tristeza
consternação	tristeza
dissabor	tristeza
amargura	tristeza
dor	tristeza
pesar	tristeza
pena	tristeza
inquietação	tristeza
padecimento	tristeza
infortúnio	tristeza
mortificação	tristeza
luto	tristeza
fúria	raiva
ira	raiva
cólera	raiva
irritação	raiva
ódio	raiva
gana	raiva
furor	raiva
zanga	raiva
agressividade	raiva
sanha	raiva
exasperação	raiva
frustração	raiva
indignação	raiva
aversão	raiva
horror	raiva
repulsão	raiva
repulsa	raiva
ojeriza	raiva
asco	raiva
antipatia	raiva
animosidade	raiva
odiosidade	raiva
execração	raiva
desprezo	raiva
rancor	raiva
ressentimento	raiva
hidrofobia	raiva
danação	raiva
moléstia	raiva
desejo	raiva
apetite	raiva
ânsia	raiva
paixão	raiva
náusea	nojo
enjoo	nojo
repugnância	nojo
fastio	nojo
abominação	nojo
enojo	nojo
engulho	nojo
antojo	nojo
dó	nojo
crepe	nojo
cipreste	nojo
vergonha	nojo
pudor	nojo
recato	nojo
decoro	nojo
pejo	nojo
constrangimento	nojo
tédio	nojo
aborrecimento	nojo
chatice	nojo
enfado	nojo
amolação	nojo
pavor	medo
fobia	medo
terror	medo
pânico	medo
temor	medo
susto	medo
amedrontamento	medo
receio	medo
apreensão	medo
preocupação	medo
ansiedade	medo
incerteza	medo
dúvida	medo
covardia	medo
fraqueza	medo
frouxidão	medo
poltronaria	medo
pusilanimidade	medo
poltronice	medo
ignávia	medo
médico	medo
camarção	medo
jubilidade	alegria
oásis	alegria
carinho	alegria
carícia	alegria
afago	alegria
cortesia	alegria
educação	alegria
gentileza	alegria
gratificação	alegria
gorjeta	alegria
caixinha	alegria
beneplácito	alegria
consentimento	alegria
aprovação	alegria
prazimento	alegria
mimo	alegria
agradecimento	alegria
perfume	alegria
complacência	alegria
delícia	alegria
volúpia	alegria
comodidade	alegria
conveniência	alegria
sanção	alegria
cômodo	alegria
bem-aventurança	alegria
sorte	alegria
ventura	alegria
dita	alegria
fortuna	alegria
sucesso	alegria
êxito	alegria
triunfo	alegria
vitória	alegria
acerto	alegria
congratulações	alegria
felicitações	alegria
cumprimentos	alegria
exultação	alegria
passatempo	alegria
satisfazer	alegria
comprazer	alegria
aprazer	alegria
agradar	alegria
permissão	alegria
alvoroço	alegria
amenidade	alegria
arrebatamento	alegria
exaltação	alegria
excitação	alegria
calma	alegria
conforto	alegria
despreocupação	alegria
disposição	alegria
otimismo	alegria
tranquilidade	alegria
aconchego	alegria
saúde	alegria
segurança	alegria
beatitude	alegria
bem	alegria
vontade	alegria
independência	alegria
prosperidade	alegria
benevolência	alegria
benignidade	alegria
condescendência	alegria
estorvo	alegria
conteúdo	alegria
doçura	alegria
desenfado	alegria
maravilha	alegria
alienação	alegria
arroubo	alegria
êxtase	alegria
absorção	alegria
delírio	alegria
endeusamento	alegria
embevecimento	alegria
enlevamento	alegria
fascínio	alegria
transporte	alegria
suspensão	alegria
embriaguez	alegria
encanto	alegria
enleio	alegria
anagogia	alegria
contemplação	alegria
espasmo	alegria
enlevação	alegria
voo	alegria
ardor	alegria
energia	alegria
calor	alegria
fervor	alegria
flama	alegria
força	alegria
ímpeto	alegria
impulso	alegria
interesse	alegria
sentimento	alegria
veemência	alegria
vida	alegria
vigor	alegria
admiração	alegria
encantamento	alegria
frenesi	alegria
frenesim	alegria
centelha	alegria
elã	alegria
estro	alegria
iluminação	alegria
inspiração	alegria
lampejo	alegria
sopro	alegria
transe	alegria
paladar	alegria
gustação	alegria
sabor	alegria
sensação	alegria
palato	alegria
saibo	alegria
apetência	alegria
fome	alegria
aptidão	alegria
propensão	alegria
predileção	alegria
predisposição	alegria
inclinação	alegria
tendência	alegria
preferência	alegria
simpatia	alegria
queda	alegria
fraco	alegria
pendor	alegria
habilidade	alegria
vocação	alegria
veia	alegria
sensibilidade	alegria
bom gosto	alegria
elegância	alegria
finura	alegria
fineza	alegria
refinamento	alegria
requinte	alegria
esmero	alegria
primor	alegria
discrição	alegria
harmonia	alegria
maneira	alegria
modo	alegria
jeito	alegria
estilo	alegria
forma	alegria
critério	alegria
opinião	alegria
discernimento	alegria
escolha	alegria
juízo	alegria
alvitre	alegria
arbítrio	alegria
capricho	alegria
fantasia	alegria
mercê	alegria
bel-prazer	alegria
talante	alegria
opção	alegria
retribuição	alegria
recompensa	alegria
molhadela	alegria
posse	alegria
uso	alegria
usufruto	alegria
utilização	alegria
fruição	alegria
desfrute	alegria
proveito	alegria
poder	alegria
usufruição	alegria
aproveitamento	alegria
graça	alegria
hilaridade	alegria
orgasmo	alegria
clímax	alegria
gozação	alegria
gracejo	alegria
brincadeira	alegria
humor	alegria
invernada	alegria
engorda	alegria
alimento	alegria
comida	alegria
alimentação	alegria
assunto	alegria
pastagem	alegria
tema	alegria
campo	alegria
prado	alegria
ervaçal	alegria
forragem	alegria
brinde	alegria
oferta	alegria
resguardo	alegria
agasalho	alegria
dádiva	alegria
presente	alegria
surpresa	alegria
lembrança	alegria
bobagem	alegria
prenda	alegria
aleluia	alegria
rejubilação	alegria
sol	alegria
sorriso	alegria
zombaria	alegria
gargalhada	alegria
chacota	alegria
ridículo	alegria
risada	alegria
judiaria	alegria
judiação	alegria
celebração	alegria
comemoração	alegria
festividade	alegria
festejo	alegria
festança	alegria
festim	alegria
solenidade	alegria
cerimônia	alegria
evento	alegria
sarau	alegria
festival	alegria
banquete	alegria
folgança	alegria
pândega	alegria
função	alegria
folia	alegria
descanso	alegria
feriado	alegria
folga	alegria
féria	alegria
recesso	alegria
trégua	alegria
lazer	alegria
troça	alegria
onda	alegria
recreio	alegria
alívio	alegria
disparate	alegria
orgia	alegria
cambalhota	alegria
episódio	alegria
brinco	alegria
brinquedo	alegria
desporto	alegria
espairecimento	alegria
espetáculo	alegria
esporte	alegria
jogo	alegria
programa	alegria
atração	alegria
hobby	alegria
desenfadamento	alegria
entretém	alegria
entretimento	alegria
baderna	alegria
bacanal	alegria
bebedeira	alegria
bródio	alegria
deboche	alegria
dissipação	alegria
estroinice	alegria
gaudério	alegria
pagode	alegria
patuscada	alegria
reinação	alegria
gandaia	alegria
súcia	alegria
bagunça	alegria
esbórnia	alegria
fuzarca	alegria
noitada	alegria
noite	alegria
opa	alegria
rapioca	alegria
saturnal	alegria
carnaval	alegria
azar	tristeza
desgraça	tristeza
fatalidade	tristeza
desdita	tristeza
desventura	tristeza
misantropia	tristeza
aborto	tristeza
mal	tristeza
adversidade	tristeza
calamidade	tristeza
catástrofe	tristeza
revés	tristeza
tragédia	tristeza
tormento	tristeza
mesquinhez	tristeza
contratempo	tristeza
intempérie	tristeza
castigo	tristeza
volta	tristeza
lástima	tristeza
golpe	tristeza
derrota	tristeza
negrura	tristeza
negrume	tristeza
miséria	tristeza
moleza	tristeza
atribulação	tristeza
caiporismo	tristeza
casmurrice	tristeza
hipocondria	tristeza
insucesso	tristeza
macaca	tristeza
mofina	tristeza
morrinha	tristeza
peso	tristeza
suicídio	tristeza
taciturnidade	tristeza
transtorno	tristeza
urucubaca	tristeza
vicissitude	tristeza
zica	tristeza
tanglomanglo	tristeza
malemolência	tristeza
desagrado	tristeza
decepção	tristeza
desprazer	tristeza
inconformação	tristeza
desprazimento	tristeza
contrariedade	tristeza
malgrado	tristeza
abate	tristeza
nirvana	tristeza
baixa	tristeza
rebaixamento	tristeza
debilidade	tristeza
enfraquecimento	tristeza
acabrunhamento	tristeza
abaixamento	tristeza
dedução	tristeza
desconto	tristeza
diminuição	tristeza
humilhação	tristeza
languidez	tristeza
palerma	tristeza
abalo	tristeza
caimento	tristeza
decadência	tristeza
declínio	tristeza
ruína	tristeza
escuridão	tristeza
baixeza	tristeza
indiferença	tristeza
anemia	tristeza
astenia	tristeza
letargia	tristeza
estrago	tristeza
fossa	tristeza
diferença	tristeza
apatia	tristeza
arrefecimento	tristeza
redução	tristeza
desgaste	tristeza
matança	tristeza
lentidão	tristeza
esgotamento	tristeza
torpor	tristeza
opressão	tristeza
aniquilamento	tristeza
atimia	tristeza
derrubada	tristeza
descaimento	tristeza
desvalorização	tristeza
lombeira	tristeza
marasmo	tristeza
morbidez	tristeza
nostalgia	tristeza
quebra	tristeza
quebradeira	tristeza
quebramento	tristeza
quebrantamento	tristeza
amortização	tristeza
bônus	tristeza
inanição	tristeza
subtração	tristeza
umbigo	tristeza
decremento	tristeza
depleção	tristeza
adelgaçamento	tristeza
desinteresse	tristeza
saudade	tristeza
banzo	tristeza
desespero	tristeza
desconfiança	tristeza
derrotismo	tristeza
desconforto	tristeza
malacia	tristeza
viuvez	tristeza
desconsolação	tristeza
afeição	tristeza
morte	tristeza
sufoco	tristeza
pecado	tristeza
trauma	tristeza
desmaio	tristeza
desfalecimento	tristeza
síncope	tristeza
preguiça	tristeza
amortecimento	tristeza
perda	tristeza
má sorte	tristeza
desastre	tristeza
tribulação	tristeza
desfortúnio	tristeza
desgraceira	tristeza
mal-estar	tristeza
melindre	tristeza
amofinação	tristeza
amuo	tristeza
agrura	tristeza
desilusão	tristeza
desapontamento	tristeza
desencanto	tristeza
desencantamento	tristeza
arrependimento	tristeza
penar	tristeza
suplício	tristeza
martírio	tristeza
calvário	tristeza
prova	tristeza
provação	tristeza
tortura	tristeza
dificuldade	tristeza
penúria	tristeza
pobreza	tristeza
flagelo	tristeza
paciência	tristeza
resignação	tristeza
conformação	tristeza
conformidade	tristeza
tolerância	tristeza
incômodo	tristeza
maçada	tristeza
apoquentação	tristeza
aperreação	tristeza
agastamento	tristeza
insipidez	tristeza
sensaboria	tristeza
desenxabimento	tristeza
desenxabidez	tristeza
acrimônia	tristeza
acidez	tristeza
azedume	tristeza
amargor	tristeza
agonia	tristeza
ferida	tristeza
acerbidade	tristeza
agror	tristeza
frágua	tristeza
contrição	tristeza
remorso	tristeza
piedade	tristeza
comiseração	tristeza
compaixão	tristeza
condoimento	tristeza
condolência	tristeza
contristação	tristeza
lágrimas	tristeza
cólica	tristeza
algia	tristeza
dor de cabeça	tristeza
abalançar	tristeza
romanear	tristeza
sopesar	tristeza
avaliar	tristeza
apreciar	tristeza
analisar	tristeza
considerar	tristeza
estimar	tristeza
estudar	tristeza
examinar	tristeza
observar	tristeza
ponderar	tristeza
presumir	tristeza
imaginar	tristeza
calcular	tristeza
conjecturar	tristeza
prever	tristeza
supor	tristeza
influenciar	tristeza
atuar	tristeza
induzir	tristeza
influir	tristeza
instigar	tristeza
intervir	tristeza
motivar	tristeza
sugestionar	tristeza
recair	tristeza
incidir	tristeza
apertar	tristeza
calcar	tristeza
estender-se	tristeza
imprensar	tristeza
oprimir	tristeza
premer	tristeza
prensar	tristeza
pressionar	tristeza
sobrecarregar	tristeza
abater	tristeza
aborrecer	tristeza
chatear	tristeza
desagradar	tristeza
descontentar	tristeza
desgostar	tristeza
estorvar	tristeza
importunar	tristeza
incomodar	tristeza
maçar	tristeza
magoar	tristeza
perturbar	tristeza
apiedar	tristeza
comiserar	tristeza
comover	tristeza
compadecer	tristeza
compungir	tristeza
condoer	tristeza
consternar	tristeza
contristar	tristeza
emocionar	tristeza
enternecer	tristeza
entristecer	tristeza
molestar	tristeza
penalizar	tristeza
sensibilizar	tristeza
tocar	tristeza
equilibrar-se	tristeza
compunção	tristeza
desrespeito	tristeza
nuvem	tristeza
pesadume	tristeza
pluma	tristeza
penacho	tristeza
penalidade	tristeza
multa	tristeza
corretivo	tristeza
lição	tristeza
punição	tristeza
condenação	tristeza
coima	tristeza
expiação	tristeza
penitência	tristeza
compadecimento	tristeza
miseração	tristeza
cálamo	tristeza
escrita	tristeza
escritor	tristeza
autor	tristeza
ter pena de	tristeza
doença	tristeza
achaque	tristeza
afecção	tristeza
enfermidade	tristeza
morbo	tristeza
afronta	tristeza
trabalho	tristeza
distúrbio	tristeza
anojamento	tristeza
solda	tristeza
assanhamento	raiva
vingança	raiva
garra	raiva
anseio	raiva
avidez	raiva
sofreguidão	raiva
voracidade	raiva
rompante	raiva
repente	raiva
acesso	raiva
malquerença	raiva
impetuosidade	raiva
moda	raiva
repelo	raiva
violência	raiva
voga	raiva
loucura	raiva
embravecimento	raiva
encarniçamento	raiva
tesão	raiva
enguiço	raiva
feitiço	raiva
mau-olhado	raiva
quebranto	raiva
incompatibilidade	raiva
braveza	raiva
enfurecimento	raiva
ferocidade	raiva
briga	raiva
desavença	raiva
inimizade	raiva
luta	raiva
rixa	raiva
avaria	raiva
defeito	raiva
falha	raiva
agressão	raiva
hostilidade	raiva
hostilização	raiva
ofensa	raiva
dureza	raiva
brutalidade	raiva
bestialidade	raiva
belicosidade	raiva
dinamismo	raiva
empreendimento	raiva
atividade	raiva
ousadia	raiva
intolerância	raiva
crueldade	raiva
monstruosidade	raiva
barbaridade	raiva
atrocidade	raiva
hediondez	raiva
selvajaria	raiva
desumanidade	raiva
crime	raiva
feiura	raiva
monstro	raiva
bicho	raiva
diabo	raiva
mostrengo	raiva
canhão	raiva
bruxa	raiva
bruaca	raiva
xaveco	raiva
bagulho	raiva
jararaca	raiva
bucho	raiva
dinheirão	raiva
dinheirada	raiva
dinheirama	raiva
exorbitância	raiva
batelada	raiva
monte	raiva
montão	raiva
quantidade	raiva
abundância	raiva
enxurrada	raiva
porção	raiva
profusão	raiva
série	raiva
chorrilho	raiva
mundo	raiva
mundaréu	raiva
amontoado	raiva
intensamente	raiva
muito	raiva
bastante	raiva
imenso	raiva
demais	raiva
demasiado	raiva
demasiadamente	raiva
excessivamente	raiva
exageradamente	raiva
asca	raiva
enjeitamento	raiva
entejo	raiva
estranhamento	raiva
repelência	raiva
repúdio	raiva
resistência	raiva
oposição	raiva
objeção	raiva
contestação	raiva
denegação	raiva
divergência	raiva
impugnação	raiva
nega	raiva
negaça	raiva
negação	raiva
negamento	raiva
recusa	raiva
refusão	raiva
refutação	raiva
rejeição	raiva
cisma	raiva
antagonismo	raiva
desafeição	raiva
implicação	raiva
implicância	raiva
pontinha	raiva
quizília	raiva
teiró	raiva
alergia	raiva
contragosto	raiva
embirração	raiva
quizila	raiva
mau humor	raiva
animadversão	raiva
prevenção	raiva
arrojo	raiva
audácia	raiva
bravura	raiva
brio	raiva
coragem	raiva
determinação	raiva
intrepidez	raiva
valentia	raiva
desdém	raiva
desconsideração	raiva
desapreço	raiva
descaso	raiva
frieza	raiva
desatenção	raiva
menosprezo	raiva
menoscabo	raiva
depreciação	raiva
vilipêndio	raiva
detração	raiva
pouco-caso	raiva
desacato	raiva
negligência	raiva
desfavor	raiva
desamor	raiva
desculto	raiva
desprendimento	raiva
abandono	raiva
desapego	raiva
alheamento	raiva
renúncia	raiva
abnegação	raiva
isenção	raiva
relutância	raiva
queixa	raiva
despeito	raiva
fel	raiva
ciúme	raiva
escamação	raiva
mossa	raiva
ressaibo	raiva
higrofobia	raiva
querer	raiva
aspiração	raiva
cobiça	raiva
cupidez	raiva
febre	raiva
apego	raiva
ambição	raiva
sede	raiva
lubricidade	raiva
tentação	raiva
concupiscência	raiva
atração física	raiva
libido	raiva
apetite sexual	raiva
lascívia	raiva
propósito	raiva
pretensão	raiva
desígnio	raiva
intenção	raiva
intento	raiva
anelo	raiva
intuito	raiva
devaneio	raiva
extravagância	raiva
mania	raiva
obstinação	raiva
sonho	raiva
teimosia	raiva
veleidade	raiva
veneta	raiva
rasgo	raiva
cabeça	raiva
ganância	raiva
precedência	raiva
primazia	raiva
amor	raiva
lazeira	raiva
pimenta	raiva
estuação	nojo
naupatia	nojo
tontura	nojo
abuso	nojo
entojo	nojo
enfaro	nojo
anorexia	nojo
cansaço	nojo
canseira	nojo
fadiga	nojo
inapetência	nojo
quebreira	nojo
sufocação	nojo
saciedade	nojo
displicência	nojo
monotonia	nojo
xarope	nojo
enojamento	nojo
chateação	nojo
vazio	nojo
pasmaceira	nojo
problema	nojo
pepino	nojo
fumo	nojo
braçal	nojo
vexame	nojo
desonra	nojo
enxovalho	nojo
opróbrio	nojo
ignomínia	nojo
demérito	nojo
descrédito	nojo
aviltamento	nojo
desdouro	nojo
desdoiro	nojo
labéu	nojo
timidez	nojo
acanhamento	nojo
introversão	nojo
insegurança	nojo
retraimento	nojo
reserva	nojo
embaraço	nojo
recolhimento	nojo
encolhimento	nojo
rubor	nojo
decência	nojo
compostura	nojo
virtude	nojo
moralidade	nojo
seriedade	nojo
pudicícia	nojo
honra	nojo
amor-próprio	nojo
dignidade	nojo
orgulho	nojo
integridade	nojo
pundonor	nojo
dormideira	nojo
castidade	nojo
honestidade	nojo
inocência	nojo
modéstia	nojo
pureza	nojo
despretensão	nojo
singeleza	nojo
cautela	nojo
cuidado	nojo
precaução	nojo
abstinência	nojo
subtileza	nojo
austeridade	nojo
severidade	nojo
ingenuidade	nojo
linha	nojo
sutileza	nojo
modos	nojo
comedimento	nojo
maneiras	nojo
equilíbrio	nojo
circunspeção	nojo
lisura	nojo
honradez	nojo
correção	nojo
nobreza	nojo
probidade	nojo
respeitabilidade	nojo
retidão	nojo
impedimento	nojo
obstáculo	nojo
confusão	nojo
pudícia	nojo
ameaça	nojo
imposição	nojo
coação	nojo
coerção	nojo
coibição	nojo
intimidação	nojo
repressão	nojo
limitação	nojo
confrangimento	nojo
cerceamento	nojo
restrição	nojo
tolhimento	nojo
encabulação	nojo
encabulamento	nojo
aperto	nojo
compressão	nojo
constrição	nojo
pressão	nojo
estopada	nojo
perturbação	nojo
lassidão	nojo
arrelia	nojo
cacetada	nojo
caceteação	nojo
chateza	nojo
chatura	nojo
importunação	nojo
maçadoria	nojo
xaropada	nojo
arrufo	nojo
vácuo	nojo
arrenegação	nojo
enfadamento	nojo
estafa	nojo
flagelação	nojo
seca	nojo
espanto	medo
alarma	medo
cagaço	medo
estarrecimento	medo
respeito	medo
caguira	medo
sobrosso	medo
reverência	medo
obediência	medo
veneração	medo
sobressalto	medo
desassossego	medo
inquietude	medo
assombro	medo
tremor	medo
pontualidade	medo
zelo	medo
diligência	medo
empenho	medo
rigor	medo
escrúpulo	medo
salto	medo
tremura	medo
espavento	medo
alarme	medo
assombração	medo
peladura	medo
acovardamento	medo
intranquilidade	medo
consumição	medo
pressentimento	medo
hesitação	medo
suspeita	medo
suspeição	medo
arquejo	medo
estertor	medo
impaciência	medo
vasca	medo
estresse	medo
stress	medo
ofego	medo
anelação	medo
dubiedade	medo
ambiguidade	medo
dubiez	medo
imprecisão	medo
indecisão	medo
indefinição	medo
indeterminação	medo
interrogação	medo
irresolução	medo
oscilação	medo
perplexidade	medo
vacilação	medo
cobardia	medo
tremelique	medo
maricagem	medo
adinamia	medo
fragilidade	medo
atonia	medo
debilitação	medo
definhamento	medo
depauperação	medo
esfalfamento	medo
extenuação	medo
fraqueira	medo
neurastenia	medo
acobardamento	medo
desbrio	medo
tibiez	medo
tibieza	medo
vício	medo
deficiência	medo
deformidade	medo
deslustre	medo
eiva	medo
falta	medo
imperfeição	medo
ineficácia	medo
ineficiência	medo
inutilidade	medo
mácula	medo
mancha	medo
senão	medo
indefensabilidade	medo
vulnerabilidade	medo
delicadeza	medo
palidez	medo
amizade	alegria
apreço	alegria
brandura	alegria
consideração	alegria
cafuné	alegria
meiguice	alegria
ternura	alegria
atenção	alegria
desvelo	alegria
proteção	alegria
festinhas	alegria
blandície	alegria
adulação	alegria
festas	alegria
afagamento	alegria
blandícia	alegria
lisonja	alegria
amabilidade	alegria
apaparico	alegria
favor	alegria
paparico	alegria
apoio	alegria
benesse	alegria
favorecimento	alegria
polidez	alegria
cordialidade	alegria
afabilidade	alegria
graciosidade	alegria
deferência	alegria
cavalheirismo	alegria
política	alegria
polimento	alegria
lhaneza	alegria
urbanidade	alegria
civilidade	alegria
solicitude	alegria
galanteria	alegria
cumprimento	alegria
vênia	alegria
mesura	alegria
saudação	alegria
salva	alegria
cortejo	alegria
rapapé	alegria
salamaleque	alegria
zumbaia	alegria
homenagem	alegria
tributo	alegria
louvor	alegria
preito	alegria
benefício	alegria
obséquio	alegria
distinção	alegria
donaire	alegria
galhardia	alegria
garbo	alegria
garbosidade	alegria
propina	alegria
adiafa	alegria
emolumento	alegria
espórtula	alegria
lambidela	alegria
molha	alegria
molhadura	alegria
mota	alegria
cafezinho	alegria
cerveja	alegria
copinho	alegria
cinzel	alegria
escopro	alegria
caixote	alegria
relicário	alegria
boceta	alegria
xixica	alegria
licença	alegria
autorização	alegria
concessão	alegria
concordância	alegria
anuência	alegria
aquiescência	alegria
assentimento	alegria
deferimento	alegria
aceitação	alegria
outorga	alegria
aval	alegria
adesão	alegria
aderência	alegria
acedência	alegria
acessão	alegria
nução	alegria
assenso	alegria
transigência	alegria
indulgência	alegria
flexibilidade	alegria
contemporização	alegria
compreensão	alegria
consenso	alegria
unanimidade	alegria
entendimento	alegria
acordo	alegria
consonância	alegria
oferenda	alegria
beleza	alegria
perfeição	alegria
joia	alegria
suavidade	alegria
brinco-de-princesa	alegria
fúcsia	alegria
lágrima	alegria
gratidão	alegria
gratulação	alegria
reconhecimento	alegria
compensação	alegria
paga	alegria
pagamento	alegria
prêmio	alegria
recompensação	alegria
aroma	alegria
odor	alegria
bálsamo	alegria
cheiro	alegria
eflúvio	alegria
essência	alegria
fragrância	alegria
olência	alegria
olor	alegria
água-de-colônia	alegria
colônia	alegria
unção	alegria
conchego	alegria
adequação	alegria
utilidade	alegria
faculdades	alegria
meios	alegria
recursos	alegria
coincidência	alegria
acaso	alegria
eventualidade	alegria
casualidade	alegria
contingência	alegria
acidente	alegria
imprevisto	alegria
achado	alegria
destino	alegria
fado	alegria
sina	alegria
futuro	alegria
estrela	alegria
fadário	alegria
sestro	alegria
mera	alegria
chance	alegria
percalço	alegria
tipo	alegria
espécie	alegria
gênero	alegria
categoria	alegria
qualidade	alegria
classe	alegria
variedade	alegria
família	alegria
laia	alegria
ganho	alegria
lucro	alegria
vantagem	alegria
condição	alegria
posição	alegria
nível	alegria
parte	alegria
quinhão	alegria
pedaço	alegria
cota	alegria
quota	alegria
meio	alegria
fim	alegria
termo	alegria
final	alegria
término	alegria
desfecho	alegria
conclusão	alegria
remate	alegria
bruxaria	alegria
feitiçaria	alegria
magia	alegria
mágica	alegria
sortilégio	alegria
panela	alegria
bruxedo	alegria
boa sorte	alegria
perigo	alegria
risco	alegria
bafejo	alegria
cadeia	alegria
presídio	alegria
penitenciária	alegria
xilindró	alegria
cárcere	alegria
xadrez	alegria
referida	alegria
expressa	alegria
exposta	alegria
manda	alegria
determina	alegria
impõe	alegria
estabelece	alegria
chamada	alegria
denominada	alegria
riqueza	alegria
herança	alegria
fazenda	alegria
recurso	alegria
bens	alegria
posses	alegria
acervo	alegria
algo	alegria
liga	alegria
luxo	alegria
fábula	alegria
aventura	alegria
natural	alegria
dinheiro	alegria
erva	alegria
haver	alegria
vento	alegria
chorume	alegria
coco	alegria
nota	alegria
ouro	alegria
patrimônio	alegria
coisas	alegria
feito	alegria
conquista	alegria
troféu	alegria
vencimento	alegria
brilharete	alegria
brilhantura	alegria
acontecimento	alegria
ocorrência	alegria
fato	alegria
lance	alegria
caso	alegria
incidente	alegria
peripécia	alegria
sucedido	alegria
acontecido	alegria
resultado	alegria
desenlace	alegria
decorrência	alegria
fruto	alegria
repercussão	alegria
efeito	alegria
resulta	alegria
resultância	alegria
corolário	alegria
coroamento	alegria
parto	alegria
parição	alegria
apoteose	alegria
capitólio	alegria
aclamação	alegria
aplauso	alegria
ovação	alegria
superioridade	alegria
hegemonia	alegria
predominância	alegria
preponderância	alegria
predomínio	alegria
prevalência	alegria
supremacia	alegria
império	alegria
pompa	alegria
esplendor	alegria
suntuosidade	alegria
fausto	alegria
imponência	alegria
enfeite	alegria
ornamento	alegria
adorno	alegria
ornato	alegria
certeza	alegria
acertamento	alegria
atino	alegria
exatidão	alegria
justeza	alegria
precisão	alegria
adaptação	alegria
ajustado	alegria
ajustamento	alegria
combinação	alegria
compromisso	alegria
conchavo	alegria
contrato	alegria
convenção	alegria
trato	alegria
cabimento	alegria
ponderação	alegria
prudência	alegria
reflexão	alegria
sabedoria	alegria
sensatez	alegria
senso	alegria
tino	alegria
bom senso	alegria
oportunidade	alegria
propriedade	alegria
ajuste	alegria
regulação	alegria
regulagem	alegria
cortesias	alegria
mesuras	alegria
salamaleques	alegria
parabéns	alegria
recomendação	alegria
rendimento	alegria
visita	alegria
agachados	alegria
embora	alegria
recomendações	alegria
aplicações	alegria
bastar	alegria
atender	alegria
chegar	alegria
alegrar	alegria
contentar	alegria
rejubilar	alegria
cumprir	alegria
corresponder	alegria
desempenhar	alegria
executar	alegria
realizar	alegria
indenizar	alegria
liquidar	alegria
pagar	alegria
quitar	alegria
retribuir	alegria
saldar	alegria
solver	alegria
empanturrar	alegria
desforrar-se	alegria
fartar	alegria
mitigar	alegria
saciar	alegria
vingar-se	alegria
esclarecer	alegria
convencer	alegria
persuadir	alegria
perfazer	alegria
obedecer	alegria
preencher	alegria
respeitar	alegria
reparar	alegria
suprir	alegria
remediar	alegria
desagravar	alegria
sorrir	alegria
condescender	alegria
contemporizar	alegria
transigir	alegria
permitir	alegria
regozijar	alegria
deliciar	alegria
deleitar	alegria
divertir	alegria
animar	alegria
encantar	alegria
regalar	alegria
distrair	alegria
entreter	alegria
enlevar	alegria
letificar	alegria
pascer	alegria
atrair	alegria
cativar	alegria
mimar	alegria
acarinhar	alegria
afagar	alegria
apaixonar-se	alegria
afeiçoar-se	alegria
enamorar-se	alegria
encantar-se	alegria
gostar	alegria
destorroar	alegria
esterroar	alegria
gradar	alegria
gradear	alegria
serenidade	alegria
leveza	alegria
ataque	alegria
agitação	alegria
alma	alegria
movimento	alegria
fissura	alegria
súbito	alegria
vivacidade	alegria
abrasamento	alegria
focagem	alegria
gama	alegria
incandescência	alegria
instinto	alegria
rapto	alegria
surto	alegria
empolgação	alegria
bonança	alegria
calmaria	alegria
paz	alegria
quietação	alegria
quietude	alegria
relaxamento	alegria
remanso	alegria
repouso	alegria
silêncio	alegria
sossego	alegria
vagar	alegria
eutimia	alegria
fleuma	alegria
impassibilidade	alegria
imperturbabilidade	alegria
mansidão	alegria
pacacidade	alegria
pacatez	alegria
calidez	alegria
bafo	alegria
canícula	alegria
mormaceira	alegria
mormaço	alegria
quentura	alegria
soalheira	alegria
consolação	alegria
refrigério	alegria
alento	alegria
frescor	alegria
auxílio	alegria
consolo	alegria
lenitivo	alegria
remédio	alegria
esperança	alegria
confiança	alegria
positividade	alegria
aprazibilidade	alegria
placidez	alegria
crença	alegria
mansarrão	alegria
normalidade	alegria
estabilidade	alegria
ordem	alegria
regularidade	alegria
aninho	alegria
abraço	alegria
abrigo	alegria
acolhimento	alegria
amparo	alegria
arrimo	alegria
comunicação	alegria
junção	alegria
ligação	alegria
proximidade	alegria
união	alegria
paraíso	alegria
misticismo	alegria
convenientemente	alegria
acertadamente	alegria
adequadamente	alegria
certo	alegria
devidamente	alegria
corretamente	alegria
satisfatoriamente	alegria
excelentemente	alegria
direito	alegria
habilmente	alegria
talentosamente	alegria
comodamente	alegria
à vontade	alegria
com saúde	alegria
em harmonia	alegria
confortavelmente	alegria
em paz	alegria
claramente	alegria
distintamente	alegria
exatamente	alegria
justamente	alegria
nitidamente	alegria
perfeitamente	alegria
precisamente	alegria
condignamente	alegria
cortesmente	alegria
educadamente	alegria
elegantemente	alegria
certamente	alegria
provavelmente	alegria
seguramente	alegria
assaz	alegria
extremamente	alegria
bondade	alegria
caráter	alegria
ética	alegria
moral	alegria
amado	alegria
querido	alegria
cabedais	alegria
haveres	alegria
tesouro	alegria
ainda bem	alegria
pois bem	alegria
bem-educado	alegria
bem-posto	alegria
bem-sucedido	alegria
bem-acabado	alegria
bem-vestido	alegria
alvedrio	alegria
líbito	alegria
mando	alegria
moto-próprio	alegria
volição	alegria
dedicação	alegria
aplicação	alegria
ânimo	alegria
firmeza	alegria
capricheira	alegria
decisão	alegria
deliberação	alegria
resolução	alegria
carência	alegria
necessidade	alegria
boa vontade	alegria
abastança	alegria
fartura	alegria
cabedal	alegria
capital	alegria
aumento	alegria
crescimento	alegria
desenvolvimento	alegria
melhora	alegria
melhoria	alegria
progresso	alegria
clemência	alegria
filantropia	alegria
generosidade	alegria
beneficência	alegria
humanidade	alegria
atrapalhação	alegria
atravancamento	alegria
atravanco	alegria
barranco	alegria
barreira	alegria
bloqueio	alegria
busílis	alegria
cadeado	alegria
complicação	alegria
embargo	alegria
empacho	alegria
empata	alegria
empecilho	alegria
empeço	alegria
empeno	alegria
encalhe	alegria
encravo	alegria
encrenca	alegria
entrave	alegria
estafermo	alegria
estorva	alegria
gargalo	alegria
imbondo	alegria
impasse	alegria
inconveniente	alegria
intercepção	alegria
interdição	alegria
interrupção	alegria
mas	alegria
nó	alegria
óbice	alegria
obstrução	alegria
pespego	alegria
pior	alegria
porém	alegria
prejuízo	alegria
prisão	alegria
proibição	alegria
remora	alegria
tope	alegria
torniquete	alegria
trambolho	alegria
tropeço	alegria
vedação	alegria
xeque	alegria
carga	alegria
prodígio	alegria
fenômeno	alegria
portento	alegria
milagre	alegria
colosso	alegria
deslumbramento	alegria
maravilhamento	alegria
pasmo	alegria
apuro	alegria
impecabilidade	alegria
calêndula	alegria
arroubamento	alegria
intensidade	alegria
glorificação	alegria
vaidade	alegria
presunção	alegria
deificação	alegria
divinização	alegria
idealização	alegria
carregamento	alegria
transportação	alegria
deslocamento	alegria
deslocação	alegria
viagem	alegria
condução	alegria
porte	alegria
translado	alegria
traslado	alegria
locomoção	alegria
movimentação	alegria
mobilidade	alegria
locomobilidade	alegria
veículo	alegria
viatura	alegria
carro	alegria
transportamento	alegria
transferência	alegria
passagem	alegria
transposição	alegria
mudança	alegria
transcrição	alegria
manifestação	alegria
revelação	alegria
exibição	alegria
exteriorização	alegria
demonstração	alegria
pileque	alegria
porre	alegria
bico	alegria
ebriedade	alegria
pua	alegria
peludo	alegria
fogo	alegria
porco	alegria
chuva	alegria
água	alegria
camoeca	alegria
cana	alegria
gata	alegria
piteira	alegria
vinho	alegria
ganso	alegria
despacho	alegria
macumba	alegria
malefício	alegria
mandinga	alegria
necromancia	alegria
nigromancia	alegria
poção	alegria
atrativo	alegria
formosura	alegria
magnetismo	alegria
fascinação	alegria
sedução	alegria
laço	alegria
liame	alegria
vínculo	alegria
contração	alegria
convulsão	alegria
voejo	alegria
adejo	alegria
elevação	alegria
realização	alegria
marcha	alegria
caminhada	alegria
andança	alegria
passo	alegria
ardência	alegria
ardimento	alegria
brasa	alegria
incêndio	alegria
afinco	alegria
tocha	alegria
chama	alegria
labareda	alegria
influência	alegria
efervescência	alegria
esto	alegria
estuo	alegria
fogueira	alegria
inflamação	alegria
lirismo	alegria
esforço	alegria
ação	alegria
eficácia	alegria
eficiência	alegria
potência	alegria
fortaleza	alegria
prontidão	alegria
pujança	alegria
robustez	alegria
viço	alegria
fibra	alegria
caloria	alegria
aquecimento	alegria
afrontamento	alegria
queimor	alegria
afeto	alegria
afinidade	alegria
confraternidade	alegria
empatia	alegria
estima	alegria
fraternidade	alegria
solidariedade	alegria
vitalidade	alegria
fervura	alegria
afervoramento	alegria
devoção	alegria
exuberância	alegria
efusão	alegria
multiplicidade	alegria
religião	alegria
religiosidade	alegria
aguça	alegria
alor	alegria
pulsão	alegria
encorajamento	alegria
estímulo	alegria
incentivo	alegria
incitamento	alegria
instigação	alegria
arranque	alegria
arranco	alegria
empurrão	alegria
impulsão	alegria
impulsionamento	alegria
pulso	alegria
batimento	alegria
importância	alegria
relevância	alegria
valia	alegria
dimensão	alegria
magnitude	alegria
vulto	alegria
monta	alegria
préstimo	alegria
curiosidade	alegria
egoísmo	alegria
individualismo	alegria
egocentrismo	alegria
bem-querer	alegria
juro	alegria
dividendo	alegria
galardão	alegria
emoção	alegria
vivência	alegria
comoção	alegria
querença	alegria
envolvimento	alegria
convicção	alegria
intuição	alegria
palpite	alegria
faro	alegria
bacorejo	alegria
presságio	alegria
noção	alegria
sentido	alegria
consciência	alegria
ideia	alegria
conceito	alegria
concepção	alegria
qualidades	alegria
índole	alegria
natureza	alegria
coração	alegria
temperamento	alegria
feitio	alegria
pêsames	alegria
condolências	alegria
existência	alegria
presença	alegria
época	alegria
fase	alegria
idade	alegria
motivação	alegria
relato	alegria
biografia	alegria
memórias	alegria
fauna	alegria
flora	alegria
começo	alegria
causa	alegria
início	alegria
origem	alegria
emprego	alegria
ocupação	alegria
ofício	alegria
prática	alegria
profissão	alegria
passadio	alegria
subsistência	alegria
sustento	alegria
espírito	alegria
ser	alegria
substância	alegria
alicerce	alegria
base	alegria
fundamento	alegria
pilar	alegria
suporte	alegria
sustentação	alegria
sustentáculo	alegria
qualidade de vida	alegria
agraço	alegria
luxúria	alegria
verde	alegria
verdor	alegria
verdura	alegria
vicejo	alegria
validade	alegria
valor	alegria
vigência	alegria
afã	alegria
ênfase	alegria
provocação	alegria
dengue	alegria
talismã	alegria
ofuscação	alegria
prestígio	alegria
denguice	alegria
malfeito	alegria
dengo	alegria
alucinação	alegria
correria	alegria
azáfama	alegria
pressa	alegria
dança	alegria
rebuliço	alegria
corre-corre	alegria
lufa-lufa	alegria
roda-viva	alegria
turbilhão	alegria
desordem	alegria
vendaval	alegria
polvorosa	alegria
conflito	alegria
motim	alegria
revolta	alegria
tumulto	alegria
algazarra	alegria
balbúrdia	alegria
barulho	alegria
afobação	alegria
bulício	alegria
caos	alegria
conturbação	alegria
crise	alegria
revolução	alegria
precipitação	alegria
ebulição	alegria
fervedouro	alegria
burburinho	alegria
deus nos acuda	alegria
urgência	alegria
ápice	alegria
faísca	alegria
fagulha	alegria
chispa	alegria
faúlha	alegria
corisco	alegria
luz	alegria
epifania	alegria
insight	alegria
clarão	alegria
brilho	alegria
fulgor	alegria
cintilação	alegria
raio	alegria
fulguração	alegria
luzeiro	alegria
revérbero	alegria
lume	alegria
lua	alegria
cio	alegria
plectro	alegria
verve	alegria
poesia	alegria
musa	alegria
toque	alegria
gênio	alegria
lira	alegria
descoberta	alegria
nitidez	alegria
luzerna	alegria
luzimento	alegria
hálito	alegria
brisa	alegria
aragem	alegria
viração	alegria
anélito	alegria
fôlego	alegria
folgo	alegria
respiração	alegria
suspiro	alegria
ar	alegria
aura	alegria
bocejo	alegria
som	alegria
bufo	alegria
combate	alegria
falecimento	alegria
incorporação	alegria
traspassamento	alegria
característica	alegria
cunho	alegria
peculiaridade	alegria
teor	alegria
tom	alegria
comicidade	alegria
jocosidade	alegria
orexia	alegria
desnutrição	alegria
subalimentação	alegria
subnutrição	alegria
escassez	alegria
indigência	alegria
inópia	alegria
míngua	alegria
privação	alegria
rafa	alegria
unha de fome	alegria
identidade	alegria
igualdade	alegria
pessoa agradável	alegria
ritual	alegria
caidela	alegria
caída	alegria
tombo	alegria
boléu	alegria
trambolhão	alegria
baque	alegria
queda-d'água	alegria
catarata	alegria
catadupa	alegria
cascata	alegria
cachoeira	alegria
cachão	alegria
desprestígio	alegria
cessação	alegria
decaída	alegria
depauperamento	alegria
derrocada	alegria
desabamento	alegria
desmoronamento	alegria
destruição	alegria
empobrecimento	alegria
esfacelamento	alegria
involução	alegria
ocaso	alegria
outono	alegria
perecimento	alegria
atraimento	alegria
demissão	alegria
deposição	alegria
destituição	alegria
culpa	alegria
erro	alegria
declive	alegria
descida	alegria
vertente	alegria
desvio	alegria
enfraquecido	alegria
debilitado	alegria
débil	alegria
fracote	alegria
doente	alegria
adoentado	alegria
abatido	alegria
franzino	alegria
anêmico	alegria
alquebrado	alegria
acabadiço	alegria
langoroso	alegria
lânguido	alegria
despreparado	alegria
incompetente	alegria
incapaz	alegria
inábil	alegria
inferior	alegria
imperfeito	alegria
péssimo	alegria
ruim	alegria
insuficiente	alegria
mediano	alegria
medíocre	alegria
ralo	alegria
suave	alegria
tênue	alegria
ameno	alegria
frágil	alegria
delicado	alegria
fino	alegria
quebradiço	alegria
quebrável	alegria
brando	alegria
manso	alegria
tolerante	alegria
transigente	alegria
condescendente	alegria
flexível	alegria
permissivo	alegria
moderado	alegria
comedido	alegria
covarde	alegria
cobarde	alegria
medroso	alegria
temeroso	alegria
receoso	alegria
assustado	alegria
assustadiço	alegria
pusilânime	alegria
tímido	alegria
timorato	alegria
espantado	alegria
espantadiço	alegria
mofino	alegria
pávido	alegria
poltrão	alegria
parco	alegria
escasso	alegria
limitado	alegria
minguado	alegria
pequeno	alegria
reduzido	alegria
diminuto	alegria
ligeiro	alegria
irrisório	alegria
miúdo	alegria
mole	alegria
frouxo	alegria
flácido	alegria
fofo	alegria
macio	alegria
tenro	alegria
indeciso	alegria
irresoluto	alegria
incerto	alegria
hesitante	alegria
vacilante	alegria
titubeante	alegria
claudicante	alegria
duvidoso	alegria
desvalido	alegria
indefeso	alegria
vulnerável	alegria
desprotegido	alegria
desamparado	alegria
abandonado	alegria
desgraçado	alegria
miserável	alegria
pobre	alegria
tuberculoso	alegria
tísico	alegria
ponto fraco	alegria
aclive	alegria
encosta	alegria
ladeira	alegria
quebrada	alegria
rampa	alegria
know-how	alegria
competência	alegria
capacidade	alegria
habilitação	alegria
idoneidade	alegria
maestria	alegria
mestria	alegria
perícia	alegria
talento	alegria
virtuosismo	alegria
agilidade	alegria
destreza	alegria
ligeireza	alegria
velocidade	alegria
rapidez	alegria
perspicácia	alegria
esperteza	alegria
inteligência	alegria
sagacidade	alegria
malícia	alegria
astúcia	alegria
argúcia	alegria
manha	alegria
vaso	alegria
nervura	alegria
conduta	alegria
apreciação	alegria
emotividade	alegria
sentimentalidade	alegria
excitabilidade	alegria
percepção	alegria
receptividade	alegria
impressionabilidade	alegria
melindrismo	alegria
suscetibilidade	alegria
agudeza	alegria
artifício	alegria
lábia	alegria
paleio	alegria
solércia	alegria
raridade	alegria
ardil	alegria
acuidade	alegria
diplomacia	alegria
estreiteza	alegria
hospitalidade	alegria
penetração	alegria
verniz	alegria
sofisticação	alegria
finesse	alegria
obrigação	alegria
galantaria	alegria
galanteio	alegria
corte	alegria
razão	alegria
ensino	alegria
serviço	alegria
raciocínio	alegria
inconsistência	alegria
bom-tom	alegria
refinação	alegria
exagero	alegria
aperfeiçoamento	alegria
cultivo	alegria
civilização	alegria
edificação	alegria
apuração	alegria
apuramento	alegria
lapidação	alegria
limadura	alegria
aprumo	alegria
requintamento	alegria
desmando	alegria
excesso	alegria
imoderação	alegria
atilamento	alegria
meticulosidade	alegria
minúcia	alegria
acabamento	alegria
aprimoramento	alegria
alinho	alegria
asseio	alegria
trinque	alegria
arte	alegria
excelência	alegria
sublimidade	alegria
magnificência	alegria
flor	alegria
magnanimidade	alegria
proporção	alegria
proporcionalidade	alegria
simetria	alegria
equiparação	alegria
afinação	alegria
eufonia	alegria
melodia	alegria
cadência	alegria
concerto	alegria
eurritmia	alegria
concórdia	alegria
coerência	alegria
coesão	alegria
conciliação	alegria
avença	alegria
guisa	alegria
atributo	alegria
método	alegria
técnica	alegria
estado	alegria
ocasião	alegria
ensejo	alegria
possibilidade	alegria
momento	alegria
vez	alegria
hora	alegria
espaço	alegria
brecha	alegria
azo	alegria
aberta	alegria
circunstância	alegria
situação	alegria
conjuntura	alegria
conjunção	alegria
contexto	alegria
cenário	alegria
aspecto	alegria
aparência	alegria
semblante	alegria
feição	alegria
exterioridade	alegria
figura	alegria
formato	alegria
feitura	alegria
arranjo	alegria
configuração	alegria
organização	alegria
ordenação	alegria
distribuição	alegria
arranjamento	alegria
arrumação	alegria
comportamento	alegria
atitude	alegria
desta maneira	alegria
dessa maneira	alegria
estratégia	alegria
fórmula	alegria
procedimento	alegria
sistema	alegria
costume	alegria
regra	alegria
hábito	alegria
boas maneiras	alegria
moderação	alegria
escala	alegria
graduação	alegria
módulo	alegria
modus	alegria
do modo que	alegria
de modo	alegria
de modo que	alegria
grosso modo	alegria
deste modo	alegria
do mesmo modo	alegria
desse modo	alegria
dedo	alegria
dom	alegria
facilidade	alegria
fachada	alegria
saída	alegria
expediente	alegria
solução	alegria
tineta	alegria
luxação	alegria
torcedura	alegria
entorse	alegria
torção	alegria
gesticulação	alegria
gesto	alegria
meneio	alegria
tato	alegria
tento	alegria
praxe	alegria
charme	alegria
pose	alegria
direção	alegria
linguagem	alegria
registro	alegria
afetação	alegria
pernosticismo	alegria
rebuscamento	alegria
retórica	alegria
simulação	alegria
fisionomia	alegria
talhe	alegria
arquitetura	alegria
constituição	alegria
construção	alegria
desenho	alegria
estrutura	alegria
perfil	alegria
alinhamento	alegria
fila	alegria
fileira	alegria
formação	alegria
formatura	alegria
perfilhamento	alegria
flexão	alegria
arquétipo	alegria
matriz	alegria
modelo	alegria
molde	alegria
de forma	alegria
da mesma forma	alegria
dessa forma	alegria
desta forma	alegria
cordura	alegria
circunspecção	alegria
razoabilidade	alegria
siso	alegria
conhecimento	alegria
experiência	alegria
informação	alegria
avaliação	alegria
análise	alegria
seleção	alegria
separação	alegria
triagem	alegria
eleição	alegria
nomeação	alegria
proclamação	alegria
definição	alegria
designação	alegria
alternativa	alegria
caminho	alegria
pitaco	alegria
sugestão	alegria
conselho	alegria
julgamento	alegria
parecer	alegria
proposta	alegria
aviso	alegria
dispor	alegria
alvitramento	alegria
aposta	alegria
desvario	alegria
inconstância	alegria
instabilidade	alegria
irregularidade	alegria
variabilidade	alegria
volubilidade	alegria
teima	alegria
insistência	alegria
birra	alegria
impertinência	alegria
pertinácia	alegria
timbre	alegria
excentricidade	alegria
originalidade	alegria
imaginativa	alegria
criatividade	alegria
imaginação	alegria
inventividade	alegria
criação	alegria
invenção	alegria
faz-de-conta	alegria
ficção	alegria
ilusão	alegria
quimera	alegria
utopia	alegria
esquisitice	alegria
visão	alegria
aparição	alegria
fantasma	alegria
bijuteria	alegria
marca	alegria
característico	alegria
remuneração	alegria
indenização	alegria
reparação	alegria
ressarcimento	alegria
restituição	alegria
banho	alegria
molhamento	alegria
lambujem	alegria
retenção	alegria
monopólio	alegria
possessão	alegria
jurisdição	alegria
investidura	alegria
admissão	alegria
empossamento	alegria
divícia	alegria
pecúlio	alegria
rendimentos	alegria
conhecimentos	alegria
coito	alegria
cópula	alegria
copulação	alegria
execução	alegria
exercício	alegria
desempenho	alegria
rotina	alegria
tradição	alegria
usança	alegria
serventia	alegria
prestabilidade	alegria
proficuidade	alegria
prestança	alegria
prestância	alegria
disponha	alegria
tenha	alegria
aproveite	alegria
granjeio	alegria
provento	alegria
aplicabilidade	alegria
adiantamento	alegria
autoridade	alegria
poderio	alegria
comando	alegria
controle	alegria
domínio	alegria
diretoria	alegria
presidência	alegria
mão	alegria
alçada	alegria
faculdade	alegria
condão	alegria
dominação	alegria
soberania	alegria
ascendência	alegria
conservação	alegria
guarda	alegria
engenho	alegria
governo	alegria
regime	alegria
copiosidade	alegria
afluxo	alegria
afluência	alegria
procuração	alegria
delegação	alegria
atribuição	alegria
mandato	alegria
ser capaz	alegria
conseguir	alegria
controlar	alegria
saber	alegria
lograr	alegria
suportar	alegria
aguentar	alegria
tolerar	alegria
aturar	alegria
arriscar-se	alegria
expor-se	alegria
exploração	alegria
avanço	alegria
melhoramento	alegria
risota	alegria
chalaça	alegria
chocarrice	alegria
galhofa	alegria
graçola	alegria
pulha	alegria
motejo	alegria
piada	alegria
chiste	alegria
pilhéria	alegria
mote	alegria
apodadura	alegria
chasco	alegria
dichote	alegria
gaiatice	alegria
patacoada	alegria
pela	alegria
joguete	alegria
escárnio	alegria
mangação	alegria
laracha	alegria
anedota	alegria
logro	alegria
ludíbrio	alegria
facécia	alegria
bailarico	alegria
canja	alegria
sopa	alegria
fácil	alegria
simples	alegria
descomplicação	alegria
compleição	alegria
risibilidade	alegria
fluido	alegria
líquido	alegria
umidade	alegria
invernia	alegria
inverno	alegria
ceva	alegria
comestível	alegria
comer	alegria
prato	alegria
petisco	alegria
manjar	alegria
iguaria	alegria
maná	alegria
vianda	alegria
víveres	alegria
vitualhas	alegria
mantimento	alegria
nutrição	alegria
nutrimento	alegria
provisão	alegria
provimento	alegria
fomento	alegria
alavanca	alegria
favorecedor	alegria
estimulante	alegria
motor	alegria
mola	alegria
ração	alegria
papa	alegria
refeição	alegria
repasto	alegria
almoço	alegria
jantar	alegria
lanche	alegria
merenda	alegria
ceia	alegria
rancho	alegria
jantarada	alegria
almoçarada	alegria
rango	alegria
consoada	alegria
boda	alegria
rega-bofe	alegria
comezaina	alegria
comezana	alegria
ingestão	alegria
deglutição	alegria
consumo	alegria
culinária	alegria
cozinha	alegria
negociata	alegria
patifaria	alegria
roubo	alegria
roubalheira	alegria
comedeira	alegria
comilança	alegria
ladroeira	alegria
concussão	alegria
temática	alegria
tópico	alegria
ponto	alegria
matéria	alegria
argumento	alegria
questão	alegria
tese	alegria
trama	alegria
particular	alegria
objeto	alegria
motivo	alegria
quesito	alegria
elevado	alegria
erguido	alegria
levantado	alegria
assumpto	alegria
proposição	alegria
enunciado	alegria
apresentação	alegria
enunciação	alegria
asserção	alegria
radical	alegria
campina	alegria
plaino	alegria
planície	alegria
campanha	alegria
planura	alegria
pradaria	alegria
solo	alegria
terreno	alegria
torrão	alegria
gleba	alegria
lavrada	alegria
leira	alegria
leiva	alegria
pastio	alegria
pastoreio	alegria
plantação	alegria
roça	alegria
roçado	alegria
seara	alegria
semeada	alegria
vale	alegria
varga	alegria
vargem	alegria
várzea	alegria
interior	alegria
província	alegria
área	alegria
extensão	alegria
superfície	alegria
âmbito	alegria
esfera	alegria
arena	alegria
cancha	alegria
circo	alegria
estacada	alegria
gramado	alegria
liça	alegria
picadeiro	alegria
pista	alegria
quadra	alegria
recinto	alegria
relvado	alegria
divisão	alegria
facção	alegria
grupo	alegria
lado	alegria
partido	alegria
plano	alegria
quadro	alegria
justificativa	alegria
razão de ser	alegria
fundo	alegria
horizonte	alegria
paisagem	alegria
hipódromo	alegria
turfe	alegria
chã	alegria
raso	alegria
feno	alegria
felicitação	alegria
voto	alegria
congratulação	alegria
oferecimento	alegria
promessa	alegria
policitação	alegria
licitação	alegria
liquidação	alegria
pechincha	alegria
queima	alegria
saldo	alegria
doação	alegria
donativo	alegria
esmola	alegria
sacrifício	alegria
oblação	alegria
oblata	alegria
imolação	alegria
ofertório	alegria
envio	alegria
dedicatória	alegria
blindagem	alegria
parapeito	alegria
peitoril	alegria
abrigada	alegria
asilo	alegria
cobertura	alegria
defesa	alegria
reduto	alegria
refúgio	alegria
valhacouto	alegria
dieta	alegria
coberto	alegria
guarida	alegria
anteparo	alegria
traçado	alegria
enxuto	alegria
salvaguarda	alegria
balaústre	alegria
escudo	alegria
égide	alegria
preservação	alegria
previdência	alegria
providência	alegria
regaço	alegria
hospedagem	alegria
alojamento	alegria
socorro	alegria
roupa	alegria
vestimenta	alegria
veste	alegria
abafo	alegria
capa	alegria
abafador	alegria
acolhida	alegria
quente	alegria
suéter	alegria
atualidade	alegria
hoje	alegria
atual	alegria
corrente	alegria
vigente	alegria
recente	alegria
contemporâneo	alegria
hodierno	alegria
moderno	alegria
existente	alegria
exposto	alegria
exibido	alegria
recordação	alegria
espectador	alegria
testemunha	alegria
assistente	alegria
pronto	alegria
aqui	alegria
assíduo	alegria
aplicado	alegria
dedicado	alegria
interessado	alegria
diligente	alegria
desvelado	alegria
pertinaz	alegria
persistente	alegria
frequente	alegria
lembrado	alegria
gravado	alegria
memorizado	alegria
recordado	alegria
manifesto	alegria
claro	alegria
evidente	alegria
patente	alegria
irrefutável	alegria
palpável	alegria
indubitável	alegria
provado	alegria
inconteste	alegria
choque	alegria
estranheza	alegria
inesperado	alegria
repentino	alegria
bobeira	alegria
besteira	alegria
patetice	alegria
idiotice	alegria
tolice	alegria
tontice	alegria
baboseira	alegria
asneira	alegria
imbecilidade	alegria
palermice	alegria
absurdo	alegria
despropósito	alegria
despautério	alegria
parvoíce	alegria
estultícia	alegria
estupidez	alegria
necedade	alegria
sandice	alegria
asnice	alegria
burrice	alegria
insignificância	alegria
bagatela	alegria
frivolidade	alegria
futilidade	alegria
ridicularia	alegria
quinquilharia	alegria
bugiganga	alegria
ninharia	alegria
niquice	alegria
nada	alegria
migalhice	alegria
nica	alegria
tareco	alegria
palha	alegria
nuga	alegria
nugacidade	alegria
bugiaria	alegria
bufarinha	alegria
frioleira	alegria
porcaria	alegria
guloseima	alegria
gulodice	alegria
gulosice	alegria
lambarice	alegria
lambugem	alegria
palhaçada	alegria
bobice	alegria
bufonaria	alegria
truanice	alegria
arlequinada	alegria
momice	alegria
comédia	alegria
farsa	alegria
predicado	alegria
dote	alegria
favorece	alegria
siriri	alegria
gabo	alegria
louvaminha	alegria
claridade	alegria
luminosidade	alegria
clareza	alegria
resplendor	alegria
resplandecência	alegria
guia	alegria
farol	alegria
bússola	alegria
intelecto	alegria
dia	alegria
roda	alegria
guarda-sol	alegria
smile	alegria
apodo	alegria
ironia	alegria
caçoada	alegria
chacoteação	alegria
chacotice	alegria
chança	alegria
chincalhada	alegria
chufa	alegria
debique	alegria
derriço	alegria
desfruto	alegria
dictério	alegria
irrisão	alegria
matraca	alegria
mofa	alegria
momo	alegria
remoque	alegria
sarcasmo	alegria
sátira	alegria
tiro	alegria
tripúdio	alegria
zoada	alegria
achicalhe	alegria
achincalhação	alegria
achincalhamento	alegria
chincalho	alegria
escarnecimento	alegria
escarninho	alegria
partida	alegria
achincalhe	alegria
moca	alegria
zoeira	alegria
surriada	alegria
maldade	alegria
perversidade	alegria
malvadeza	alegria
maus-tratos	alegria
malignidade	alegria
truculência	alegria
sevícia	alegria
acinte	alegria
gueto	alegria
ghetto	alegria
ato	alegria
recepção	alegria
fuzuê	alegria
gala	alegria
reunião	alegria
aniversário	alegria
jubileu	alegria
ágape	alegria
convite	alegria
convívio	alegria
pedantismo	alegria
aparato	alegria
auto	alegria
majestade	alegria
lanço	alegria
jogada	alegria
serão	alegria
festivo	alegria
afável	alegria
alegre	alegria
animado	alegria
aprazível	alegria
divertido	alegria
jucundo	alegria
espetáculos	alegria
eventos	alegria
acúmulo	alegria
pausa	alegria
sota	alegria
dormida	alegria
sono	alegria
descontração	alegria
ócio	alegria
lerdeza	alegria
morosidade	alegria
vagarosidade	alegria
encosto	alegria
espeque	alegria
patamar	alegria
sueto	alegria
férias	alegria
parança	alegria
refolgo	alegria
dispensa	alegria
ociosidade	alegria
desocupação	alegria
inatividade	alegria
inação	alegria
vacação	alegria
intervalo	alegria
sobra	alegria
desaperto	alegria
largueza	alegria
alargamento	alegria
margem	alegria
desafogo	alegria
respiro	alegria
aliviação	alegria
aliviamento	alegria
atrevimento	alegria
desaforo	alegria
insolência	alegria
desplante	alegria
descaramento	alegria
desfaçatez	alegria
parada	alegria
paragem	alegria
escondedouro	alegria
esconderijo	alegria
escaninho	alegria
esconso	alegria
lugarejo	alegria
recanto	alegria
recôndito	alegria
retiro	alegria
rincão	alegria
âmago	alegria
imo	alegria
interioridade	alegria
íntimo	alegria
segredo	alegria
afastamento	alegria
distanciamento	alegria
vaga	alegria
cacho	alegria
ondulação	alegria
sinuosidade	alegria
ziguezague	alegria
jorro	alegria
torrente	alegria
barato	alegria
curtição	alegria
fingimento	alegria
dissimulação	alegria
falsidade	alegria
artimanha	alegria
enganação	alegria
engodo	alegria
estratagema	alegria
ostentação	alegria
embrulhada	alegria
desatino	alegria
dislate	alegria
pedantice	alegria
tagarelice	alegria
toleima	alegria
contra-senso	alegria
blasfêmia	alegria
incoerência	alegria
desacerto	alegria
inépcia	alegria
maluqueira	alegria
maluquice	alegria
rata	alegria
aluamento	alegria
basbaquice	alegria
batata	alegria
cabeçada	alegria
desconchavo	alegria
destampatório	alegria
destempero	alegria
disparidade	alegria
enormidade	alegria
gafe	alegria
heresia	alegria
ilogismo	alegria
insensatez	alegria
irracionalidade	alegria
lorota	alegria
pequenice	alegria
tonteira	alegria
paradoxo	alegria
contrassenso	alegria
abobrinha	alegria
suruba	alegria
surubada	alegria
desperdício	alegria
esbanjamento	alegria
anarquia	alegria
bambochata	alegria
cambota	alegria
cabriola	alegria
pirueta	alegria
viravolta	alegria
pincho	alegria
reviravolta	alegria
sarabanda	alegria
argola	alegria
arrecada	alegria
pendente	alegria
penduricalho	alegria
pingente	alegria
adereço	alegria
paramento	alegria
hibisco	alegria
papoula	alegria
teteia	alegria
desporte	alegria
desportivo	alegria
esportivo	alegria
informal	alegria
competição	alegria
desafio	alegria
encontro	alegria
certame	alegria
batalha	alegria
peleja	alegria
pugna	alegria
rodada	alegria
conjunto	alegria
coleção	alegria
funcionamento	alegria
manipulação	alegria
trapaça	alegria
esquema	alegria
ardileza	alegria
indústria	alegria
treta	alegria
socapa	alegria
balanço	alegria
manuseio	alegria
manuseamento	alegria
manejo	alegria
manobra	alegria
show	alegria
sessão	alegria
peça	alegria
passeio	alegria
software	alegria
aplicativo	alegria
programação	alegria
lista	alegria
conteúdos	alegria
matérias	alegria
disciplinas	alegria
tópicos	alegria
pontos	alegria
planejamento	alegria
planeamento	alegria
projeto	alegria
roteiro	alegria
esboço	alegria
prospecto	alegria
plataforma	alegria
prostituição	alegria
meretrício	alegria
bando	alegria
corja	alegria
malta	alegria
estúrdia	alegria
descompostura	alegria
barafunda	alegria
inferno	alegria
zona	alegria
sequela	alegria
zorra	alegria
devassidão	alegria
libertinagem	alegria
devasso	alegria
bacântico	alegria
báquico	alegria
carnal	alegria
dissoluto	alegria
licencioso	alegria
orgíaco	alegria
bacanália	alegria
aturdimento	alegria
borracheira	alegria
carraspana	alegria
prego	alegria
mona	alegria
pifão	alegria
rasca	alegria
tiorga	alegria
flauteio	alegria
depravação	alegria
desregramento	alegria
imoralidade	alegria
despudor	alegria
dissolução	alegria
degeneração	alegria
indecência	alegria
corrupção	alegria
perversão	alegria
licenciosidade	alegria
desonestidade	alegria
libidinagem	alegria
impudicícia	alegria
singularidade	alegria
altanadice	alegria
templo	alegria
baile	alegria
ídolo	alegria
funçanata	alegria
boemia	alegria
léu	alegria
vadiação	alegria
vadiagem	alegria
vagabundagem	alegria
tuna	alegria
chinfrim	alegria
insônia	alegria
vigília	alegria
lucubração	alegria
elucubração	alegria
trevas	alegria
breu	alegria
escuro	alegria
obscuridade	alegria
escuridade	alegria
chona	alegria
ignorância	alegria
desconhecimento	alegria
obscurantismo	alegria
incompreensão	alegria
incultura	alegria
insipiência	alegria
insciência	alegria
sombra	alegria
véspera	alegria
cegueira	alegria
bolas	alegria
desculpa	alegria
epa	alegria
foi mal	alegria
ops	alegria
oi	alegria
olá	alegria
balandrau	alegria
capote	alegria
mantilha	alegria
manto	alegria
pala	alegria
poncho	alegria
túnica	alegria
véu	alegria
xaile	alegria
xale	alegria
escândalo	alegria
entrudo	alegria
mascarada	alegria
azarão	tristeza
baldão	tristeza
acarretar	tristeza
causar	tristeza
ocasionar	tristeza
originar	tristeza
provocar	tristeza
drama	tristeza
fatalismo	tristeza
emergência	tristeza
sinistro	tristeza
descalabro	tristeza
desfortuna	tristeza
antropofobia	tristeza
insociabilidade	tristeza
isolamento	tristeza
reclusão	tristeza
abortamento	tristeza
desmancho	tristeza
amblose	tristeza
móvito	tristeza
fracasso	tristeza
malogro	tristeza
fiasco	tristeza
falhanço	tristeza
deformação	tristeza
anormalidade	tristeza
aberração	tristeza
anomalia	tristeza
monstrengo	tristeza
fealdade	tristeza
inadequadamente	tristeza
ilegalmente	tristeza
desarmoniosamente	tristeza
erradamente	tristeza
defeituosamente	tristeza
incorretamente	tristeza
irregularmente	tristeza
de leve	tristeza
deficientemente	tristeza
imperfeitamente	tristeza
incompletamente	tristeza
insatisfatoriamente	tristeza
insuficientemente	tristeza
pouco	tristeza
rapidamente	tristeza
a custo	tristeza
apenas	tristeza
com dificuldade	tristeza
desfavoravelmente	tristeza
dificilmente	tristeza
dificultosamente	tristeza
negativamente	tristeza
penosamente	tristeza
barbaramente	tristeza
bruscamente	tristeza
cruelmente	tristeza
desumanamente	tristeza
duramente	tristeza
grosseiramente	tristeza
impropriamente	tristeza
inconvenientemente	tristeza
indevidamente	tristeza
injustamente	tristeza
rudemente	tristeza
severamente	tristeza
jamais	tristeza
não	tristeza
nunca	tristeza
assim que	tristeza
logo que	tristeza
dano	tristeza
maldição	tristeza
adoecimento	tristeza
mazela	tristeza
desvantagem	tristeza
inconveniência	tristeza
malevolência	tristeza
nocividade	tristeza
perniciosidade	tristeza
ruindade	tristeza
mal-entendido	tristeza
borrasca	tristeza
inversão	tristeza
cataclismo	tristeza
apocalipse	tristeza
hecatombe	tristeza
armagedom	tristeza
devastação	tristeza
epidemia	tristeza
praga	tristeza
apertura	tristeza
espinho	tristeza
perseguição	tristeza
obsessão	tristeza
atenazamento	tristeza
dolência	tristeza
cilício	tristeza
cruz	tristeza
espinha	tristeza
pesadelo	tristeza
sobrecarga	tristeza
traspasso	tristeza
mesquinharia	tristeza
vileza	tristeza
sordidez	tristeza
pequenez	tristeza
avareza	tristeza
sovinice	tristeza
tenacidade	tristeza
vilania	tristeza
usura	tristeza
agarramento	tristeza
miudeza	tristeza
poupança	tristeza
somiticaria	tristeza
esganação	tristeza
pão-durismo	tristeza
tacanhice	tristeza
desaire	tristeza
sentença	tristeza
emenda	tristeza
exemplo	tristeza
preço	tristeza
escarmento	tristeza
vindita	tristeza
látego	tristeza
repreensão	tristeza
bronca	tristeza
reprimenda	tristeza
advertência	tristeza
admoestação	tristeza
ensinadela	tristeza
sermão	tristeza
sabão	tristeza
censura	tristeza
cautério	tristeza
espalhanço	tristeza
surra	tristeza
sova	tristeza
espancamento	tristeza
pancadaria	tristeza
pau	tristeza
bordoada	tristeza
esfrega	tristeza
trepa	tristeza
tosa	tristeza
tosquiadela	tristeza
tareia	tristeza
escovadela	tristeza
açoite	tristeza
malha	tristeza
malhação	tristeza
regresso	tristeza
retornamento	tristeza
retornança	tristeza
retorno	tristeza
revinda	tristeza
tornada	tristeza
vinda	tristeza
circunferência	tristeza
borda	tristeza
circuito	tristeza
circulação	tristeza
círculo	tristeza
contorno	tristeza
giro	tristeza
redor	tristeza
rodeio	tristeza
rodopio	tristeza
rotação	tristeza
translação	tristeza
girata	tristeza
virada	tristeza
viradela	tristeza
viragem	tristeza
espira	tristeza
espiral	tristeza
rosca	tristeza
volteio	tristeza
curva	tristeza
meandro	tristeza
serpeio	tristeza
tortuosidade	tristeza
guinada	tristeza
modificação	tristeza
transformação	tristeza
volta-face	tristeza
desar	tristeza
desforço	tristeza
desforra	tristeza
despique	tristeza
forra	tristeza
reação	tristeza
réplica	tristeza
replicação	tristeza
represália	tristeza
resposta	tristeza
revanche	tristeza
revide	tristeza
troco	tristeza
vindicta	tristeza
devolução	tristeza
torna	tristeza
laçada	tristeza
por volta de	tristeza
batida	tristeza
percussão	tristeza
murro	tristeza
pancada	tristeza
soco	tristeza
sopapo	tristeza
contusão	tristeza
pisadura	tristeza
equimose	tristeza
ferimento	tristeza
hematoma	tristeza
lesão	tristeza
pisadela	tristeza
traumatismo	tristeza
talho	tristeza
incisão	tristeza
chofre	tristeza
truque	tristeza
desfalque	tristeza
rombo	tristeza
amotinação	tristeza
insurreição	tristeza
levante	tristeza
motinação	tristeza
putsch	tristeza
rebelião	tristeza
sedição	tristeza
sublevação	tristeza
lufada	tristeza
rajada	tristeza
bicada	tristeza
golada	tristeza
gole	tristeza
goleta	tristeza
golo	tristeza
hausto	tristeza
pinga	tristeza
sorvo	tristeza
tragada	tristeza
trago	tristeza
aniquilação	tristeza
detrimento	tristeza
dispersão	tristeza
debandada	tristeza
destroço	tristeza
desbaratamento	tristeza
desbarato	tristeza
retirada	tristeza
desbaste	tristeza
percurso	tristeza
itinerário	tristeza
rota	tristeza
rumo	tristeza
trajetória	tristeza
órbita	tristeza
negridão	tristeza
negror	tristeza
negro	tristeza
pretidão	tristeza
pretume	tristeza
pretura	tristeza
rudeza	tristeza
aspereza	tristeza
névoa	tristeza
cerração	tristeza
neblina	tristeza
nevoeiro	tristeza
carranca	tristeza
cenho	tristeza
sobrecenho	tristeza
tromba	tristeza
maciez	tristeza
macieza	tristeza
maleabilidade	tristeza
modorra	tristeza
indolência	tristeza
inércia	tristeza
entorpecimento	tristeza
soneira	tristeza
sonolência	tristeza
langor	tristeza
molícia	tristeza
descomplicado	tristeza
acessível	tristeza
caipora	tristeza
pé	tristeza
inhaca	tristeza
ziguizira	tristeza
ziquizira	tristeza
persistência	tristeza
embezerramento	tristeza
bílis	tristeza
cano	tristeza
fubeca	tristeza
fubecada	tristeza
naufrágio	tristeza
academia	tristeza
cocoroca	tristeza
negra	tristeza
fraca	tristeza
sarna	tristeza
escabiose	tristeza
gafeira	tristeza
catinga	tristeza
fedor	tristeza
indisposição	tristeza
sereno	tristeza
vagaroso	tristeza
chuvisco	tristeza
zimbro	tristeza
gravidade	tristeza
bagagem	tristeza
carrego	tristeza
fardo	tristeza
frete	tristeza
volume	tristeza
crédito	tristeza
mérito	tristeza
dever	tristeza
encargo	tristeza
incumbência	tristeza
ônus	tristeza
responsabilidade	tristeza
náuseas	tristeza
halter	tristeza
haltere	tristeza
solidão	tristeza
solitude	tristeza
soledade	tristeza
apartamento	tristeza
insulamento	tristeza
mutismo	tristeza
mudez	tristeza
mudeza	tristeza
calada	tristeza
incomunicação	tristeza
desengano	tristeza
desarranjo	tristeza
desconcerto	tristeza
alteração	tristeza
desorganização	tristeza
disfunção	tristeza
jetatura	tristeza
mutabilidade	tristeza
flutuação	tristeza
desequilíbrio	tristeza
variação	tristeza
transmutação	tristeza
bicicleta	tristeza
bike	tristeza
bici	tristeza
magrela	tristeza
magrelinha	tristeza
kalanga	tristeza
camelo	tristeza
tangolomango	tristeza
desabrimento	tristeza
protesto	tristeza
estranhez	tristeza
mecha	tristeza
agredir	tristeza
desesperação	tristeza
novidade	tristeza
contraposição	tristeza
contraste	tristeza
colisão	tristeza
apesar de	tristeza
não obstante	tristeza
a despeito de	tristeza
independentemente de	tristeza
ainda que	tristeza
mesmo que	tristeza
sem embargo de	tristeza
conquanto	tristeza
má vontade	tristeza
oferece	tristeza
destaca	tristeza
pacificidade	tristeza
grandeza	tristeza
plenidão	tristeza
plenitude	tristeza
abulia	tristeza
baixada	tristeza
baixos	tristeza
decrescimento	tristeza
decréscimo	tristeza
despedimento	tristeza
exclusão	tristeza
rebaixo	tristeza
degradação	tristeza
abjeção	tristeza
indignidade	tristeza
infâmia	tristeza
capachismo	tristeza
humildade	tristeza
mediocridade	tristeza
precariedade	tristeza
atraso	tristeza
subdesenvolvimento	tristeza
impotência	tristeza
atenuação	tristeza
remissão	tristeza
atrofia	tristeza
declinação	tristeza
emagrecimento	tristeza
esvaecimento	tristeza
mitigação	tristeza
colapso	tristeza
eclipse	tristeza
precarização	tristeza
ágio	tristeza
comissão	tristeza
défice	tristeza
sensualidade	tristeza
analdia	tristeza
ignorante	tristeza
burro	tristeza
estulto	tristeza
estúpido	tristeza
idiota	tristeza
imbecil	tristeza
inepto	tristeza
lerdaço	tristeza
néscio	tristeza
parvo	tristeza
pateta	tristeza
tolo	tristeza
apalermado	tristeza
aparvalhado	tristeza
louco	tristeza
maluco	tristeza
bobo	tristeza
trouxa	tristeza
lambão	tristeza
otário	tristeza
tantã	tristeza
tonto	tristeza
peco	tristeza
desajeitado	tristeza
arara	tristeza
atoleimado	tristeza
babaquara	tristeza
banana	tristeza
basbaque	tristeza
beócio	tristeza
bestalhão	tristeza
boboca	tristeza
leso	tristeza
paspalho	tristeza
tatibitate	tristeza
zebroide	tristeza
avoado	tristeza
coió	tristeza
microcéfalo	tristeza
papelão	tristeza
mocó	tristeza
luca	tristeza
panaca	tristeza
trepidação	tristeza
estremecimento	tristeza
sacudida	tristeza
sacudidela	tristeza
abalamento	tristeza
estremeção	tristeza
frêmito	tristeza
abalada	tristeza
fuga	tristeza
tranco	tristeza
moção	tristeza
desinquietação	tristeza
dissuasão	tristeza
terremoto	tristeza
sismo	tristeza
abismo	tristeza
eversão	tristeza
embeiçamento	tristeza
rabicho	tristeza
inferioridade	tristeza
vitupério	tristeza
vulgaridade	tristeza
torpeza	tristeza
sujeira	tristeza
lama	tristeza
lodo	tristeza
canalhice	tristeza
chulice	tristeza
futricagem	tristeza
sabujice	tristeza
turpitude	tristeza
cafajestada	tristeza
suja	tristeza
exaustão	tristeza
letargo	tristeza
adormecimento	tristeza
inconsciência	tristeza
sopor	tristeza
inutilização	tristeza
danificação	tristeza
esfacelo	tristeza
apodrecimento	tristeza
deterioração	tristeza
putrefação	tristeza
depredação	tristeza
massacre	tristeza
exterminação	tristeza
extermínio	tristeza
chacina	tristeza
mortandade	tristeza
gasto	tristeza
despesa	tristeza
dispêndio	tristeza
malbaratamento	tristeza
buraco	tristeza
fosso	tristeza
concavidade	tristeza
algar	tristeza
antro	tristeza
catacumba	tristeza
caverna	tristeza
cavidade	tristeza
cova	tristeza
covil	tristeza
furna	tristeza
gruta	tristeza
lapa	tristeza
cava	tristeza
desídia	tristeza
insensibilidade	tristeza
esfriamento	tristeza
resfriamento	tristeza
refrigeração	tristeza
corrosão	tristeza
consumpção	tristeza
atrição	tristeza
erosão	tristeza
ablação	tristeza
esgotadura	tristeza
esgoto	tristeza
extinção	tristeza
despejo	tristeza
secagem	tristeza
enxugamento	tristeza
drenagem	tristeza
lassitude	tristeza
dormência	tristeza
formigamento	tristeza
desaparecimento	tristeza
eliminação	tristeza
niilismo	tristeza
remoção	tristeza
esmagamento	tristeza
pulverização	tristeza
genocídio	tristeza
subversão	tristeza
descaída	tristeza
pachorra	tristeza
estagnação	tristeza
paralisação	tristeza
imobilidade	tristeza
paralisia	tristeza
mesmice	tristeza
emaciação	tristeza
morbidade	tristeza
fragmentação	tristeza
fratura	tristeza
ruptura	tristeza
fracionamento	tristeza
partição	tristeza
fração	tristeza
quebradura	tristeza
desagregação	tristeza
descontinuação	tristeza
intermissão	tristeza
hiato	tristeza
rompimento	tristeza
rescisão	tristeza
transgressão	tristeza
violação	tristeza
infração	tristeza
falência	tristeza
bancarrota	tristeza
falimento	tristeza
insolvência	tristeza
dobra	tristeza
dobradura	tristeza
prega	tristeza
vinco	tristeza
ruga	tristeza
requebro	tristeza
bamboleio	tristeza
saracoteio	tristeza
lomba	tristeza
costado	tristeza
quebrado	tristeza
sobras	tristeza
restos	tristeza
quebra-cabeça	tristeza
quebra-cabeças	tristeza
pindaíba	tristeza
desobediência	tristeza
embigo	tristeza
protuberância	tristeza
saliência	tristeza
centro	tristeza
núcleo	tristeza
ponto central	tristeza
ponto de convergência	tristeza
ponto nuclear	tristeza
apoucamento	tristeza
encurtamento	tristeza
estreitamento	tristeza
merma	tristeza
minguamento	tristeza
minoração	tristeza
restringimento	tristeza
desentusiasmo	tristeza
imparcialidade	tristeza
sequidão	tristeza
altruísmo	tristeza
desambição	tristeza
omissão	tristeza
descuido	tristeza
desleixo	tristeza
incúria	tristeza
lembranças	tristeza
respeitos	tristeza
saudações	tristeza
escabiosa	tristeza
flor-de-viúva	tristeza
saudades	tristeza
suspiros	tristeza
viúva	tristeza
viúvas	tristeza
chibante	tristeza
feiticeiro	tristeza
tijuca	tristeza
banzeiro	tristeza
admirado	tristeza
amofinado	tristeza
amolado	tristeza
pasmado	tristeza
triste	tristeza
descrença	tristeza
desperança	tristeza
ceticismo	tristeza
pessimismo	tristeza
cepticismo	tristeza
descômodo	tristeza
descomodidade	tristeza
incomodidade	tristeza
óbito	tristeza
finamento	tristeza
fenecimento	tristeza
passamento	tristeza
decesso	tristeza
defunção	tristeza
libitina	tristeza
trânsito	tristeza
traspasse	tristeza
exício	tristeza
desaparição	tristeza
pena de morte	tristeza
engasgo	tristeza
abafação	tristeza
abafamento	tristeza
apneia	tristeza
asfixia	tristeza
afogo	tristeza
sacrilégio	tristeza
profanação	tristeza
delito	tristeza
iniquidade	tristeza
impacto	tristeza
machucado	tristeza
faniquito	tristeza
chilique	tristeza
delíquio	tristeza
esmaecimento	tristeza
lipotimia	tristeza
vertigem	tristeza
apsiquia	tristeza
desacordo	tristeza
fanico	tristeza
troço	tristeza
extravio	tristeza
descaminho	tristeza
sumiço	tristeza
ausência	tristeza
cancelamento	tristeza
supressão	tristeza
arrasamento	tristeza
arruinação	tristeza
arruinamento	tristeza
perdição	tristeza
pontapé	tristeza
treco	tristeza
disforia	tristeza
andaço	tristeza
história	tristeza
susceptibilidade	tristeza
capanga	tristeza
amuamento	tristeza
calundu	tristeza
inclemência	tristeza
escabrosidade	tristeza
desaponto	tristeza
lamentação	tristeza
metanoia	tristeza
pungimento	tristeza
reconsideração	tristeza
afligir	tristeza
atribular	tristeza
agoniar	tristeza
expiar	tristeza
resgatar	tristeza
padecer	tristeza
sofrer	tristeza
pastar	tristeza
morrer	tristeza
saborear	tristeza
confirmação	tristeza
comprovação	tristeza
evidência	tristeza
testemunho	tristeza
sinal	tristeza
indício	tristeza
indicação	tristeza
mostra	tristeza
exame	tristeza
teste	tristeza
verificação	tristeza
concurso	tristeza
disputa	tristeza
torneio	tristeza
ensaio	tristeza
experimento	tristeza
tentativa	tristeza
degustação	tristeza
provadura	tristeza
curvatura	tristeza
sinuca	tristeza
custo	tristeza
suor	tristeza
complexidade	tristeza
complexidão	tristeza
enredamento	tristeza
renitência	tristeza
mendicância	tristeza
mendicidade	tristeza
pauperismo	tristeza
paupérie	tristeza
insuficiência	tristeza
carestia	tristeza
desprovimento	tristeza
improdutividade	tristeza
infertilidade	tristeza
infecundidade	tristeza
esterilidade	tristeza
aridez	tristeza
chicote	tristeza
azorrague	tristeza
vergalho	tristeza
vergasta	tristeza
peste	tristeza
relho	tristeza
pandemia	tristeza
analogia	tristeza
compatibilidade	tristeza
correspondência	tristeza
equivalência	tristeza
parecença	tristeza
semelhança	tristeza
similaridade	tristeza
similitude	tristeza
congraçamento	tristeza
congruência	tristeza
submissão	tristeza
sujeição	tristeza
em conformidade com	tristeza
abespinhamento	tristeza
agastadura	tristeza
assomo	tristeza
platitude	tristeza
azedo	tristeza
acidade	tristeza
azedia	tristeza
amargo	tristeza
azia	tristeza
pique	tristeza
pirose	tristeza
travo	tristeza
ranço	tristeza
baba	tristeza
amarume	tristeza
afligimento	tristeza
atormentação	tristeza
descensão	tristeza
açodamento	tristeza
demora	tristeza
pieira	tristeza
lanho	tristeza
dodói	tristeza
escoriação	tristeza
úlcera	tristeza
ulceração	tristeza
chaga	tristeza
pústula	tristeza
insulto	tristeza
injúria	tristeza
ultraje	tristeza
agravo	tristeza
enternecimento	tristeza
maviosidade	tristeza
misericórdia	tristeza
pêsame	tristeza
caridade	tristeza
credo	tristeza
credulidade	tristeza
fé	tristeza
equilibrar	tristeza
contrabalançar	tristeza
compensar	tristeza
contrapesar	tristeza
equiponderar	tristeza
librar	tristeza
balançar	tristeza
balancear	tristeza
sustentar	tristeza
suster	tristeza
segurar	tristeza
apoiar	tristeza
amparar	tristeza
escorar	tristeza
firmar	tristeza
distribuir	tristeza
dividir	tristeza
subdividir	tristeza
partilhar	tristeza
repartir	tristeza
comparticipar	tristeza
ficar	tristeza
manter-se	tristeza
aguentar-se	tristeza
conter	tristeza
refrear	tristeza
deter	tristeza
domar	tristeza
enfrear	tristeza
travar	tristeza
reprimir	tristeza
sopear	tristeza
qualificar	tristeza
classificar	tristeza
ajuizar	tristeza
julgar	tristeza
pensar	tristeza
medir	tristeza
mensurar	tristeza
aquilatar	tristeza
aferir	tristeza
reputar	tristeza
equacionar	tristeza
crer	tristeza
investigar	tristeza
apreçar	tristeza
taxar	tristeza
cotar	tristeza
regular	tristeza
determinar	tristeza
computar	tristeza
contar	tristeza
quantificar	tristeza
orçar	tristeza
esmar	tristeza
suputar	tristeza
prezar	tristeza
adorar	tristeza
amar	tristeza
reverenciar	tristeza
cultuar	tristeza
admirar	tristeza
contemplar	tristeza
mirar	tristeza
fitar	tristeza
olhar	tristeza
criticar	tristeza
cogitar	tristeza
refletir	tristeza
explorar	tristeza
pesquisar	tristeza
averiguar	tristeza
verificar	tristeza
sondar	tristeza
procurar	tristeza
perscrutar	tristeza
perquirir	tristeza
escrutar	tristeza
escrutinar	tristeza
ver	tristeza
ler	tristeza
vasculhar	tristeza
esgravatar	tristeza
escarafunchar	tristeza
comentar	tristeza
decompor	tristeza
dissecar	tristeza
esmiuçar	tristeza
esquadrinhar	tristeza
minuciar	tristeza
psicanalisar	tristeza
achar	tristeza
acreditar	tristeza
sentir	tristeza
conceituar	tristeza
meditar	tristeza
matutar	tristeza
raciocinar	tristeza
cuidar	tristeza
discorrer	tristeza
reflexionar	tristeza
elucubrar	tristeza
lucubrar	tristeza
ter em conta	tristeza
levar em conta	tristeza
atentar	tristeza
interessar-se	tristeza
honrar	tristeza
valorizar	tristeza
acatar	tristeza
conceber	tristeza
pressupor	tristeza
tomar	tristeza
conjeturar	tristeza
especular	tristeza
simpatizar	tristeza
apegar-se	tristeza
benquerer	tristeza
contabilizar	tristeza
estabelecer	tristeza
antever	tristeza
entrever	tristeza
desejar	tristeza
regozijar-se	tristeza
contentar-se	tristeza
alegrar-se	tristeza
sobre-estimar	tristeza
aprender	tristeza
educar-se	tristeza
entender	tristeza
ilustrar-se	tristeza
instruir-se	tristeza
preparar-se	tristeza
compreender	tristeza
consultar	tristeza
decorar	tristeza
gravar	tristeza
guardar	tristeza
memorizar	tristeza
ensaiar	tristeza
exercitar	tristeza
praticar	tristeza
treinar	tristeza
vigiar	tristeza
debater	tristeza
discutir	tristeza
indagar	tristeza
planejar	tristeza
simular	tristeza
tratar	tristeza
versar	tristeza
ir	tristeza
cursar	tristeza
fazer	tristeza
seguir	tristeza
aprofundar	tristeza
escabichar	tristeza
espiolhar	tristeza
testar	tristeza
provar	tristeza
inspecionar	tristeza
interrogar	tristeza
questionar	tristeza
revistar	tristeza
vistoriar	tristeza
fixar	tristeza
assistir	tristeza
presenciar	tristeza
testemunhar	tristeza
constatar	tristeza
notar	tristeza
perceber	tristeza
espiar	tristeza
espreitar	tristeza
espionar	tristeza
bisbilhotar	tristeza
descobrir	tristeza
advertir	tristeza
repreender	tristeza
censurar	tristeza
admoestar	tristeza
prevenir	tristeza
replicar	tristeza
expressar	tristeza
exprimir	tristeza
avisar	tristeza
lembrar	tristeza
observar-se	tristeza
cismar	tristeza
ruminar	tristeza
alegar	tristeza
argumentar	tristeza
mencionar	tristeza
citar	tristeza
pretextar	tristeza
justificar	tristeza
expor	tristeza
arguir	tristeza
arrazoar	tristeza
suspeitar	tristeza
envaidecer-se	tristeza
gloriar-se	tristeza
jactar-se	tristeza
orgulhar-se	tristeza
ufanar-se	tristeza
vangloriar-se	tristeza
desconfiar	tristeza
duvidar	tristeza
criar	tristeza
fantasiar	tristeza
sonhar	tristeza
idealizar	tristeza
inventar	tristeza
idear	tristeza
elaborar	tristeza
projetar	tristeza
traçar	tristeza
prognosticar	tristeza
concluir	tristeza
atinar	tristeza
identificar	tristeza
deduzir	tristeza
confiar	tristeza
esperar	tristeza
aprontar	tristeza
armar	tristeza
organizar	tristeza
preparar	tristeza
admitir	tristeza
depreender	tristeza
inferir	tristeza
interrogar-se	tristeza
predizer	tristeza
pressagiar	tristeza
pressentir	tristeza
vaticinar	tristeza
adivinhar	tristeza
prenunciar	tristeza
augurar	tristeza
agourar	tristeza
agoirar	tristeza
futurar	tristeza
antecipar	tristeza
profetizar	tristeza
subentender	tristeza
aceitar	tristeza
atribuir	tristeza
acusar	tristeza
condenar	tristeza
culpabilizar	tristeza
imputar	tristeza
incriminar	tristeza
inculpar	tristeza
responsabilizar	tristeza
manipular	tristeza
levar	tristeza
inspirar	tristeza
interferir	tristeza
agir	tristeza
dominar	tristeza
obrar	tristeza
operar	tristeza
empreender	tristeza
mover-se	tristeza
lidar	tristeza
trabalhar	tristeza
concretizar	tristeza
representar	tristeza
interpretar	tristeza
encenar	tristeza
encarnar	tristeza
funcionar	tristeza
exercer	tristeza
ocupar-se	tristeza
encarregar-se	tristeza
proceder	tristeza
contribuir	tristeza
colaborar	tristeza
facilitar	tristeza
favorecer	tristeza
concorrer	tristeza
auxiliar	tristeza
valer	tristeza
coagir	tristeza
constranger	tristeza
forçar	tristeza
obrigar	tristeza
impor	tristeza
intimidar	tristeza
tutear	tristeza
compelir	tristeza
aliciar	tristeza
aconselhar	tristeza
conduzir	tristeza
encorajar	tristeza
impelir	tristeza
impulsionar	tristeza
incentivar	tristeza
incitar	tristeza
seduzir	tristeza
suscitar	tristeza
incutir	tristeza
formular	tristeza
cobrir	tristeza
emboçar	tristeza
guarnecer	tristeza
indutar	tristeza
revestir	tristeza
transmitir	tristeza
comunicar	tristeza
condicionar	tristeza
imprimir	tristeza
infundir	tristeza
insinuar	tristeza
instilar	tristeza
insuflar	tristeza
sugerir	tristeza
alentar	tristeza
entusiasmar	tristeza
estimular	tristeza
excitar	tristeza
inflamar	tristeza
importar	tristeza
interessar	tristeza
aplicar-se	tristeza
dedicar-se	tristeza
devotar-se	tristeza
entregar-se	tristeza
concitar	tristeza
desafiar	tristeza
fomentar	tristeza
acicatar	tristeza
acirrar	tristeza
açodar	tristeza
açular	tristeza
assanhar	tristeza
atiçar	tristeza
despertar	tristeza
espicaçar	tristeza
interceder	tristeza
intrometer-se	tristeza
imiscuir-se	tristeza
ingerir-se	tristeza
mexer	tristeza
meter-se	tristeza
enxerir-se	tristeza
opinar	tristeza
dizer	tristeza
falar	tristeza
manifestar	tristeza
deliberar	tristeza
gerir	tristeza
dirigir	tristeza
manobrar	tristeza
mandar	tristeza
ordenar	tristeza
comandar	tristeza
imperar	tristeza
participar	tristeza
comparecer	tristeza
suceder	tristeza
sobrevir	tristeza
acontecer	tristeza
ocorrer	tristeza
irromper	tristeza
prorromper	tristeza
desatar	tristeza
explodir	tristeza
estourar	tristeza
surgir	tristeza
gerar	tristeza
produzir	tristeza
aguçar	tristeza
avivar	tristeza
exortar	tristeza
instar	tristeza
promover	tristeza
reavivar	tristeza
vivificar	tristeza
conquistar	tristeza
envolver	tristeza
prender	tristeza
alicerçar	tristeza
basear	tristeza
declarar	tristeza
explicar	tristeza
fundamentar	tristeza
respaldar	tristeza
imbuir	tristeza
impressionar	tristeza
governar	tristeza
cantar	tristeza
encabeçar	tristeza
ministrar	tristeza
reincidir	tristeza
repetir	tristeza
insistir	tristeza
obstinar-se	tristeza
repisar	tristeza
teimar	tristeza
caber	tristeza
cair	tristeza
referir-se	tristeza
concernir	tristeza
pertencer	tristeza
aludir	tristeza
voltar	tristeza
retornar	tristeza
retomar	tristeza
regressar	tristeza
recuperar	tristeza
recobrar	tristeza
tombar	tristeza
descer	tristeza
bater	tristeza
precipitar-se	tristeza
afetar	tristeza
atingir	tristeza
acometer	tristeza
prejudicar	tristeza
lesar	tristeza
incorrer	tristeza
cair em	tristeza
cometer	tristeza
perpetrar	tristeza
efetuar	tristeza
coincidir	tristeza
assemelhar-se	tristeza
confluir	tristeza
encontrar-se	tristeza
igualar-se	tristeza
equiparar-se	tristeza
dar-se	tristeza
realizar-se	tristeza
passar-se	tristeza
verificar-se	tristeza
processar-se	tristeza
desenrolar-se	tristeza
cumprir-se	tristeza
atenuar	tristeza
diminuir	tristeza
atalhar	tristeza
aligeirar	tristeza
enfraquecer	tristeza
minorar	tristeza
carregar	tristeza
agarrar	tristeza
atarraxar	tristeza
aparafusar	tristeza
aproximar	tristeza
juntar	tristeza
unir	tristeza
cingir	tristeza
abraçar	tristeza
encolher	tristeza
aconchegar	tristeza
espremer	tristeza
comprimir	tristeza
ajustar	tristeza
estreitar	tristeza
abotoar	tristeza
atar	tristeza
enfaixar	tristeza
intensificar-se	tristeza
acentuar-se	tristeza
aumentar	tristeza
reforçar	tristeza
agravar	tristeza
piorar	tristeza
recrudescer	tristeza
acelerar	tristeza
apressar	tristeza
apressurar	tristeza
precipitar	tristeza
despachar	tristeza
adiantar	tristeza
aviar	tristeza
estugar	tristeza
abreviar	tristeza
encurtar	tristeza
angustiar	tristeza
preocupar	tristeza
inquietar	tristeza
amargurar	tristeza
desconsolar	tristeza
consumir	tristeza
desesperar	tristeza
confranger	tristeza
moer	tristeza
atormentar	tristeza
ansiar	tristeza
ameaçar	tristeza
chantagear	tristeza
economizar	tristeza
poupar	tristeza
cortar	tristeza
reduzir	tristeza
limitar	tristeza
restringir	tristeza
pisotear	tristeza
acalcanhar	tristeza
acalcar	tristeza
atropelar	tristeza
pisar	tristeza
amassar	tristeza
trilhar	tristeza
premir	tristeza
machucar	tristeza
acochar	tristeza
amachucar	tristeza
encalcar	tristeza
britar	tristeza
esmagar	tristeza
arrochar	tristeza
acabrunhar	tristeza
acapachar	tristeza
achincalhar	tristeza
apoucar	tristeza
aviltar	tristeza
deslustrar	tristeza
desonrar	tristeza
envergonhar	tristeza
espezinhar	tristeza
humilhar	tristeza
rebaixar	tristeza
ridicularizar	tristeza
ultrajar	tristeza
vexar	tristeza
vilipendiar	tristeza
transgredir	tristeza
menosprezar	tristeza
desprezar	tristeza
infringir	tristeza
decalcar	tristeza
copiar	tristeza
reproduzir	tristeza
transferir	tristeza
modelar	tristeza
moldar	tristeza
afeiçoar	tristeza
plasmar	tristeza
vazar	tristeza
orientar	tristeza
subjugar	tristeza
submeter	tristeza
sufocar	tristeza
tolher	tristeza
espora	tristeza
esporão	tristeza
alcançar	tristeza
abranger	tristeza
informar	tristeza
alastrar	tristeza
subir	tristeza
atravessar	tristeza
avançar	tristeza
confundir	tristeza
invadir	tristeza
derivar	tristeza
ganhar	tristeza
refestelar	tristeza
abordar	tristeza
desdobrar	tristeza
desenrolar	tristeza
proliferar	tristeza
render	tristeza
refestelar-se	tristeza
alastrar-se	tristeza
difundir-se	tristeza
espalhar-se	tristeza
refastelar-se	tristeza
estampar	tristeza
afrontar	tristeza
onerar	tristeza
destruir	tristeza
aniquilar	tristeza
embaraçar	tristeza
escravizar	tristeza
impedir	tristeza
tiranizar	tristeza
partir	tristeza
algemar	tristeza
encarregar	tristeza
sujeitar	tristeza
ajoujar	tristeza
aperrear	tristeza
apremar	tristeza
avassalar	tristeza
cangar	tristeza
premar	tristeza
urgir	tristeza
sobrepesar	tristeza
adelgaçar	tristeza
achatar	tristeza
cominar	tristeza
violentar	tristeza
majorar	tristeza
ampliar	tristeza
abarbar	tristeza
atravancar	tristeza
dificultar	tristeza
entravar	tristeza
nivelar	tristeza
abarrotar	tristeza
assoberbar	tristeza
encher	tristeza
azafamar	tristeza
vincular	tristeza
atarefar	tristeza
embatumar	tristeza
lotar	tristeza
desmoronar	tristeza
desabar	tristeza
ruir	tristeza
derrubar	tristeza
demolir	tristeza
arrasar	tristeza
derribar	tristeza
derruir	tristeza
derrocar	tristeza
curvar	tristeza
vergar	tristeza
deitar	tristeza
apear	tristeza
solapar	tristeza
abaixar	tristeza
baixar	tristeza
arriar	tristeza
matar	tristeza
sacrificar	tristeza
descontar	tristeza
subtrair	tristeza
amortizar	tristeza
desanimar	tristeza
deprimir	tristeza
abalar	tristeza
prostrar	tristeza
quebrantar	tristeza
derrotar	tristeza
desalentar	tristeza
desacoroçoar	tristeza
desencorajar	tristeza
desmoralizar	tristeza
desestruturar	tristeza
debilitar	tristeza
combalir	tristeza
definhar	tristeza
fatigar	tristeza
exaurir	tristeza
extenuar	tristeza
inferiorizar	tristeza
desdenhar	tristeza
depreciar	tristeza
desmerecer	tristeza
desfazer	tristeza
desacreditar	tristeza
desviar	tristeza
afastar-se	tristeza
descair	tristeza
rolar	tristeza
abominar	tristeza
detestar	tristeza
execrar	tristeza
zangar	tristeza
amolar	tristeza
agastar	tristeza
cansar	tristeza
custar	tristeza
enfadar	tristeza
enfastiar	tristeza
entediar	tristeza
enervar	tristeza
irritar	tristeza
odiar	tristeza
assaltar	tristeza
perseguir	tristeza
adormentar	tristeza
amofinar	tristeza
apoquentar	tristeza
arreliar	tristeza
azoar	tristeza
enfezar	tristeza
trautear	tristeza
cercar	tristeza
invocar	tristeza
contrariar	tristeza
torrar	tristeza
futricar	tristeza
indignar	tristeza
abodegar	tristeza
amuar	tristeza
aporrinhar	tristeza
arrenegar	tristeza
assediar	tristeza
aventar	tristeza
azucrinar	tristeza
bulir	tristeza
desamar	tristeza
desinquietar	tristeza
encabular	tristeza
enfarar	tristeza
enfestar	tristeza
enjoar	tristeza
entojar	tristeza
escamar	tristeza
futicar	tristeza
injetar	tristeza
malquerer	tristeza
mazelar	tristeza
narcotizar	tristeza
ojerizar	tristeza
paulificar	tristeza
quizilar	tristeza
rascar	tristeza
remoer	tristeza
bolinar	tristeza
acaturrar	tristeza
atazanar	tristeza
buzinar	tristeza
despeitar	tristeza
enojar	tristeza
estopar	tristeza
pentelhar	tristeza
seringar	tristeza
tamborilar	tristeza
sacanear	tristeza
maltratar	tristeza
cacetear	tristeza
judiar	tristeza
melindrar	tristeza
ofender	tristeza
rasgar	tristeza
mortificar	tristeza
afelear	tristeza
alacranar	tristeza
desapontar	tristeza
exulcerar	tristeza
marfar	tristeza
atrapalhar	tristeza
emperrar	tristeza
obstar	tristeza
sustar	tristeza
estragar	tristeza
repelir	tristeza
afastar	tristeza
abster	tristeza
evitar	tristeza
amarrar	tristeza
atrasar	tristeza
transtornar	tristeza
embargar	tristeza
vedar	tristeza
sanar	tristeza
interromper	tristeza
obstruir	tristeza
abarrancar	tristeza
bloquear	tristeza
desfavorecer	tristeza
emaranhar	tristeza
empachar	tristeza
empalhar	tristeza
empatar	tristeza
empecer	tristeza
empeçar	tristeza
pear	tristeza
pejar	tristeza
represar	tristeza
embarrilar	tristeza
obstaculizar	tristeza
infestar	tristeza
acossar	tristeza
afadigar	tristeza
estafar	tristeza
martelar	tristeza
secar	tristeza
atenazar	tristeza
azoinar	tristeza
causticar	tristeza
desadorar	tristeza
impacientar	tristeza
implicar	tristeza
relar	tristeza
revolucionar	tristeza
serrazinar	tristeza
entisicar	tristeza
matracar	tristeza
obsedar	tristeza
desacomodar	tristeza
azedar	tristeza
exasperar	tristeza
indispor	tristeza
preocupar-se	tristeza
contundir	tristeza
ferir	tristeza
abespinhar	tristeza
vulnerar	tristeza
aguilhoar	tristeza
nublar	tristeza
zurzir	tristeza
fustigar	tristeza
triturar	tristeza
chagar	tristeza
ulcerar	tristeza
despedaçar	tristeza
murchar	tristeza
enevoar	tristeza
obscurecer	tristeza
espinhar	tristeza
trespassar	tristeza
açoitar	tristeza
aleijar	tristeza
desolar	tristeza
doer	tristeza
navalhar	tristeza
ressentir	tristeza
sangrar	tristeza
supliciar	tristeza
suscetibilizar	tristeza
transpassar	tristeza
traspassar	tristeza
apunhalar	tristeza
enoitecer	tristeza
flechar	tristeza
desassossegar	tristeza
agitar	tristeza
desordenar	tristeza
desorganizar	tristeza
desarranjar	tristeza
alterar	tristeza
desestabilizar	tristeza
desequilibrar	tristeza
complicar	tristeza
inibir	tristeza
acanhar	tristeza
encavacar	tristeza
encalistrar	tristeza
atristar	tristeza
desorientar	tristeza
desnortear	tristeza
atordoar	tristeza
aturdir	tristeza
entontecer	tristeza
estontear	tristeza
tontear	tristeza
zonzar	tristeza
zonzear	tristeza
abrandar	tristeza
mover	tristeza
sacudir	tristeza
chocar	tristeza
amolecer	tristeza
derreter	tristeza
embrandecer	tristeza
empolgar	tristeza
mobilizar	tristeza
impactar	tristeza
lamentar	tristeza
prantear	tristeza
apiedar-se	tristeza
comiserar-se	tristeza
condoer-se	tristeza
deplorar	tristeza
lastimar	tristeza
pungir	tristeza
arrepender-se	tristeza
assolar	tristeza
negrejar	tristeza
apaixonar	tristeza
ensombrar	tristeza
enturvar	tristeza
sombrear	tristeza
vibrar	tristeza
possuir	tristeza
eletrizar	tristeza
encorujar-se	tristeza
emurchecer	tristeza
estiolar	tristeza
ressecar	tristeza
ressequir	tristeza
mirrar	tristeza
toldar	tristeza
anuviar	tristeza
encobrir	tristeza
escurecer	tristeza
abrumar	tristeza
obumbrar	tristeza
obnubilar	tristeza
atacar	tristeza
adicionar	tristeza
achacar	tristeza
atucanar	tristeza
beliscar	tristeza
vitimar	tristeza
torturar	tristeza
acoimar	tristeza
apenar	tristeza
autuar	tristeza
castigar	tristeza
coimar	tristeza
multar	tristeza
punir	tristeza
retalhar	tristeza
cauterizar	tristeza
enquadrar	tristeza
enlutar	tristeza
penitenciar	tristeza
sensificar	tristeza
encostar	tristeza
contactar	tristeza
contatar	tristeza
roçar	tristeza
esbarrar	tristeza
resvalar	tristeza
pegar	tristeza
tatear	tristeza
apalpar	tristeza
tanger	tristeza
dedilhar	tristeza
harpejar	tristeza
harpear	tristeza
pulsar	tristeza
marcar	tristeza
referir	tristeza
reportar-se	tristeza
ligar	tristeza
ouvir	tristeza
incluir	tristeza
competir	tristeza
incumbir	tristeza
calhar	tristeza
impender	tristeza
continuar	tristeza
prosseguir	tristeza
afugentar	tristeza
enxotar	tristeza
expulsar	tristeza
escorraçar	tristeza
magoar-se	tristeza
guiar	tristeza
encaminhar	tristeza
direcionar	tristeza
golpear	tristeza
lesionar	tristeza
equivaler	tristeza
desacatamento	tristeza
descortesia	tristeza
descumprimento	tristeza
desveneração	tristeza
incumprimento	tristeza
insubordinação	tristeza
irrespeito	tristeza
irreverência	tristeza
enevoamento	tristeza
anuviamento	tristeza
embaçamento	tristeza
embaciamento	tristeza
nébula	tristeza
turvação	tristeza
turvamento	tristeza
multidão	tristeza
crista	tristeza
coma	tristeza
capacete	tristeza
cimeira	tristeza
elmo	tristeza
topete	tristeza
martinete	tristeza
imposto	tristeza
disciplinador	tristeza
disciplinante	tristeza
disciplinar	tristeza
disciplinatório	tristeza
retificador	tristeza
corretor	tristeza
cosmético	tristeza
embelezador	tristeza
reparador	tristeza
caligrafia	tristeza
letra	tristeza
alfabeto	tristeza
abecedário	tristeza
escritura	tristeza
artigo	tristeza
escrevedura	tristeza
escrito	tristeza
redação	tristeza
reportagem	tristeza
contabilidade	tristeza
escrituração	tristeza
cronista	tristeza
historiador	tristeza
historiógrafo	tristeza
literato	tristeza
colunista	tristeza
jornalista	tristeza
noticiarista	tristeza
plumitivo	tristeza
redator	tristeza
repórter	tristeza
compositor	tristeza
artista	tristeza
músico	tristeza
escultor	tristeza
agente	tristeza
causador	tristeza
responsável	tristeza
originador	tristeza
executor	tristeza
operador	tristeza
produtor	tristeza
criador	tristeza
inventor	tristeza
pai	tristeza
descobridor	tristeza
fundador	tristeza
inaugurador	tristeza
iniciador	tristeza
instituidor	tristeza
mentor	tristeza
pretexto	tristeza
coisa	tristeza
caruara	tristeza
carregação	tristeza
desfeita	tristeza
doesto	tristeza
pirraça	tristeza
vergonheira	tristeza
vexação	tristeza
dispneia	tristeza
falta de ar	tristeza
moedeira	tristeza
assalto	tristeza
invectiva	tristeza
investida	tristeza
afrontação	tristeza
confronto	tristeza
mister	tristeza
negócio	tristeza
tarefa	tristeza
labuta	tristeza
lide	tristeza
lida	tristeza
labor	tristeza
lavor	tristeza
laboração	tristeza
faina	tristeza
afazer	tristeza
quefazer	tristeza
trabalheira	tristeza
trabalhão	tristeza
empreitada	tristeza
operação	tristeza
obra	tristeza
empresa	tristeza
produção	tristeza
elaboração	tristeza
composição	tristeza
treino	tristeza
treinamento	tristeza
furto	tristeza
saque	tristeza
pilhagem	tristeza
espoliação	tristeza
usurpação	tristeza
ladroagem	tristeza
deliberações	tristeza
discussões	tristeza
exames	tristeza
soldadura	tristeza
soldagem	tristeza
assanho	raiva
unha	raiva
gadanho	raiva
gafa	raiva
grifo	raiva
gatázio	raiva
perseverança	raiva
constância	raiva
rapacidade	raiva
tirania	raiva
jugo	raiva
prepotência	raiva
despotismo	raiva
gavinha	raiva
cirro	raiva
elo	raiva
expectativa	raiva
tensão	raiva
gula	raiva
inveja	raiva
edacidade	raiva
glutonaria	raiva
olho grande	raiva
intemperança	raiva
destemperança	raiva
descomedimento	raiva
alarvaria	raiva
arrogância	raiva
altivez	raiva
arrogante	raiva
orgulhoso	raiva
altivo	raiva
rompente	raiva
improvisação	raiva
improviso	raiva
rasteiro	raiva
rastejante	raiva
reptante	raiva
sextilha	raiva
de repente	raiva
entrada	raiva
ingresso	raiva
introdução	raiva
chegada	raiva
aproximação	raiva
avizinhação	raiva
avizinhamento	raiva
abeiramento	raiva
achegamento	raiva
alcance	raiva
obtenção	raiva
aquisição	raiva
conexão	raiva
convivência	raiva
disponibilidade	raiva
acometimento	raiva
promoção	raiva
subida	raiva
ascensão	raiva
fixação	raiva
vezo	raiva
artigos	raiva
roupas	raiva
vestuário	raiva
ária	raiva
canção	raiva
cantiga	raiva
modinha	raiva
música	raiva
toada	raiva
maior frequência	raiva
maioria	raiva
berra	raiva
coqueluche	raiva
popularidade	raiva
fama	raiva
reputação	raiva
renome	raiva
celebridade	raiva
divulgação	raiva
publicação	raiva
difusão	raiva
propagação	raiva
propalação	raiva
ritmo	raiva
andamento	raiva
curso	raiva
doidice	raiva
doideira	raiva
insanidade	raiva
demência	raiva
insânia	raiva
imprudência	raiva
inconsequência	raiva
irresponsabilidade	raiva
irreflexão	raiva
temeridade	raiva
leviandade	raiva
excepcionalidade	raiva
bizarria	raiva
adoração	raiva
idolatria	raiva
fanatismo	raiva
paranoia	raiva
psicose	raiva
dada	raiva
inconciliabilidade	raiva
inconformidade	raiva
desconformidade	raiva
desencontro	raiva
contradição	raiva
incongruência	raiva
discrepância	raiva
discordância	raiva
assimetria	raiva
fereza	raiva
brabeza	raiva
bravosidade	raiva
barbarismo	raiva
barbárie	raiva
canibalismo	raiva
bulha	raiva
duelo	raiva
enfrentamento	raiva
escaramuça	raiva
pega	raiva
pugilato	raiva
recontro	raiva
requesta	raiva
sururu	raiva
litígio	raiva
altercação	raiva
angu	raiva
atrito	raiva
bafafá	raiva
contenção	raiva
contenda	raiva
controvérsia	raiva
demanda	raiva
desaguisado	raiva
desarmonia	raiva
desentendimento	raiva
discórdia	raiva
discussão	raiva
dissensão	raiva
dissenso	raiva
dissentimento	raiva
frege	raiva
galho	raiva
pendenga	raiva
querela	raiva
rolo	raiva
rusga	raiva
salseiro	raiva
sangangu	raiva
testilha	raiva
concorrência	raiva
cisão	raiva
cizânia	raiva
desinteligência	raiva
guerra	raiva
porrada	raiva
prélio	raiva
pendência	raiva
rivalidade	raiva
zaragata	raiva
debate	raiva
desunião	raiva
tenção	raiva
derriça	raiva
justa	raiva
retesia	raiva
tendepá	raiva
pane	raiva
incorreção	raiva
inexatidão	raiva
disformidade	raiva
distorção	raiva
má-formação	raiva
malformação	raiva
balda	raiva
pecha	raiva
tinha	raiva
cinca	raiva
lapso	raiva
nequice	raiva
abertura	raiva
fenda	raiva
greta	raiva
lasca	raiva
paráclese	raiva
racha	raiva
rachadura	raiva
lacuna	raiva
janela	raiva
ofensiva	raiva
acometida	raiva
desestima	raiva
contravenção	raiva
solidez	raiva
consistência	raiva
endurecimento	raiva
enrijecimento	raiva
rigidez	raiva
rijeza	raiva
implacabilidade	raiva
inflexibilidade	raiva
rispidez	raiva
secura	raiva
grosseria	raiva
animal	raiva
indelicadeza	raiva
sangue	raiva
selvageria	raiva
abrutamento	raiva
má-criação	raiva
animalidade	raiva
grandiosidade	raiva
cometida	raiva
cometimento	raiva
iniciativa	raiva
efetuação	raiva
entrepresa	raiva
interpresa	raiva
tentame	raiva
entidade	raiva
firma	raiva
atuação	raiva
performance	raiva
presteza	raiva
pró-atividade	raiva
peito	raiva
destemor	raiva
desassombro	raiva
desembaraço	raiva
denodo	raiva
afoiteza	raiva
petulância	raiva
sem-vergonhice	raiva
sem-vergonhismo	raiva
desavergonhamento	raiva
inobservância	raiva
intimidade	raiva
familiaridade	raiva
informalidade	raiva
intromissão	raiva
crueza	raiva
impiedade	raiva
improbidade	raiva
barbaria	raiva
inumanidade	raiva
intransigência	raiva
irredutibilidade	raiva
sangue-frio	raiva
aleijão	raiva
cacogênese	raiva
teratismo	raiva
engano	raiva
equívoco	raiva
deslize	raiva
criminalidade	raiva
delinquência	raiva
feioso	raiva
criatura	raiva
ogro	raiva
besta	raiva
desumano	raiva
cruel	raiva
malvado	raiva
desalmado	raiva
perverso	raiva
bárbaro	raiva
atroz	raiva
diabólico	raiva
fera	raiva
carrasco	raiva
celerado	raiva
enorme	raiva
gigante	raiva
gigantesco	raiva
colossal	raiva
descomunal	raiva
desmedido	raiva
alimária	raiva
animalejo	raiva
animália	raiva
asno	raiva
bichano	raiva
bicho-de-pé	raiva
cupim	raiva
inseto	raiva
piolho	raiva
térmite	raiva
traça	raiva
verme	raiva
bruto	raiva
cavalo	raiva
grosseiro	raiva
grosso	raiva
mal-educado	raiva
corajoso	raiva
decidido	raiva
desassombrado	raiva
amigo	raiva
camarada	raiva
cara	raiva
chapa	raiva
fulano	raiva
ás	raiva
bom	raiva
especialista	raiva
exímio	raiva
experto	raiva
perito	raiva
bonificação	raiva
aprendiz	raiva
calouro	raiva
estudante	raiva
iniciante	raiva
novato	raiva
primeiranista	raiva
principiante	raiva
bicho do mato	raiva
insociável	raiva
misantropo	raiva
solitário	raiva
bicho-de-galinha	raiva
belzebu	raiva
anjo mau	raiva
tinhoso	raiva
lúcifer	raiva
canhoto	raiva
cão	raiva
chifrudo	raiva
cornudo	raiva
demônio	raiva
mafarrico	raiva
maldito	raiva
maligno	raiva
mau	raiva
satã	raiva
satanás	raiva
serpente	raiva
tendeiro	raiva
tentador	raiva
agitado	raiva
diabrete	raiva
irrequieto	raiva
levado	raiva
traquina	raiva
travesso	raiva
arguto	raiva
astucioso	raiva
astuto	raiva
esperto	raiva
inteligente	raiva
perspicaz	raiva
sagaz	raiva
bodega	raiva
diacho	raiva
droga	raiva
caramba	raiva
cáspite	raiva
benzedeira	raiva
necromante	raiva
adivinha	raiva
feiticeira	raiva
maga	raiva
nigromante	raiva
vidente	raiva
megera	raiva
seresma	raiva
borboleta	raiva
mariposa	raiva
panapaná	raiva
bolsa	raiva
mala	raiva
saco	raiva
meretriz	raiva
prostituta	raiva
vaca	raiva
centopeia	raiva
cantada	raiva
conversa	raiva
papo	raiva
safadeza	raiva
sacanagem	raiva
velhacaria	raiva
velhacagem	raiva
velhacada	raiva
mixaria	raiva
zé-ninguém	raiva
pé-rapado	raiva
insignificante	raiva
joão-ninguém	raiva
borra-botas	raiva
pobre-diabo	raiva
homúnculo	raiva
calhambeque	raiva
cacareco	raiva
caco	raiva
tralha	raiva
traste	raiva
trem	raiva
joça	raiva
cena	raiva
pertences	raiva
objetos	raiva
dragão	raiva
bofe	raiva
maconha	raiva
baseado	raiva
haxixe	raiva
marijuana	raiva
liamba	raiva
semente	raiva
caroço	raiva
cascavel	raiva
víbora	raiva
estômago	raiva
abdome	raiva
abdômen	raiva
bandulho	raiva
barriga	raiva
bojo	raiva
pança	raiva
panturra	raiva
ventre	raiva
bolada	raiva
dinheirame	raiva
aglomeração	raiva
fluxo	raiva
alude	raiva
avalancha	raiva
avalanche	raiva
bloco	raiva
camada	raiva
quantia	raiva
penca	raiva
feixe	raiva
magote	raiva
montanha	raiva
caterva	raiva
caudal	raiva
data	raiva
infinidade	raiva
mar	raiva
dúzia	raiva
estrupício	raiva
imensidão	raiva
oceano	raiva
caminhão	raiva
resma	raiva
serra	raiva
lixeira	raiva
pilha	raiva
floresta	raiva
número	raiva
ajuntamento	raiva
cordilheira	raiva
serrania	raiva
cabeço	raiva
colina	raiva
cômoro	raiva
montículo	raiva
morro	raiva
outeiro	raiva
proeminência	raiva
acumulação	raiva
monturo	raiva
alto	raiva
selva	raiva
frota	raiva
coluna	raiva
contingente	raiva
cúmulo	raiva
partilha	raiva
parcela	raiva
saraiva	raiva
amontoamento	raiva
cardume	raiva
enxame	raiva
pinha	raiva
ruma	raiva
braçadeira	raiva
murundu	raiva
imposta	raiva
dose	raiva
massa	raiva
cópia	raiva
superabundância	raiva
agrupamento	raiva
prodigalidade	raiva
turba	raiva
tanto	raiva
aluvião	raiva
suma	raiva
medida	raiva
total	raiva
tamanho	raiva
dilúvio	raiva
enchente	raiva
cheia	raiva
alagamento	raiva
inundação	raiva
ravina	raiva
rio	raiva
lava	raiva
influxo	raiva
enxurro	raiva
sucessão	raiva
enfiada	raiva
sequência	raiva
encadeamento	raiva
firmamento	raiva
cosmos	raiva
universo	raiva
globo	raiva
planeta	raiva
hemisfério	raiva
homem	raiva
raça humana	raiva
mortais	raiva
gênero humano	raiva
população	raiva
povo	raiva
mundéu	raiva
soma	raiva
turma	raiva
casta	raiva
estirpe	raiva
estofa	raiva
linhagem	raiva
abstergido	raiva
absterso	raiva
asseado	raiva
dessujo	raiva
imaculado	raiva
inconspurcado	raiva
lavado	raiva
limpo	raiva
mondo	raiva
polido	raiva
purificado	raiva
puro	raiva
aglomerado	raiva
amontoação	raiva
conglomerado	raiva
conglomeração	raiva
montoeira	raiva
empilhado	raiva
sobreposto	raiva
agrupado	raiva
reunido	raiva
atulhado	raiva
entulhado	raiva
apinhado	raiva
atravancado	raiva
poupado	raiva
amealhado	raiva
acumulado	raiva
junto	raiva
juntado	raiva
fortemente	raiva
profundamente	raiva
muitíssimo	raiva
imensamente	raiva
descomedidamente	raiva
grandemente	raiva
altamente	raiva
agudamente	raiva
diverso	raiva
vário	raiva
numeroso	raiva
abundante	raiva
copioso	raiva
inúmero	raiva
diferente	raiva
variado	raiva
profuso	raiva
farto	raiva
múltiplo	raiva
excessivo	raiva
exagerado	raiva
exorbitante	raiva
superabundante	raiva
intenso	raiva
sobejo	raiva
nímio	raiva
grande	raiva
deveras	raiva
sobremaneira	raiva
sobremodo	raiva
assustadoramente	raiva
indefinidamente	raiva
extraordinariamente	raiva
repetidamente	raiva
frequentemente	raiva
sempre	raiva
amiúde	raiva
abundantemente	raiva
em quantidade	raiva
nenhum	raiva
qualquer	raiva
maior	raiva
assim	raiva
excepcional	raiva
atípico	raiva
incomum	raiva
inusitado	raiva
raro	raiva
extraordinário	raiva
singular	raiva
grande parte de	raiva
muito bom	raiva
satisfatório	raiva
suficiente	raiva
suficientemente	raiva
excepcionalmente	raiva
imensurável	raiva
desmesurado	raiva
ilimitado	raiva
incalculável	raiva
incomensurável	raiva
incontável	raiva
infindo	raiva
infinito	raiva
agigantado	raiva
ingente	raiva
mastodôntico	raiva
monstruoso	raiva
paquidérmico	raiva
amplo	raiva
espaçoso	raiva
extenso	raiva
vasto	raiva
profundo	raiva
complexo	raiva
considerável	raiva
espantoso	raiva
fabuloso	raiva
fantástico	raiva
fenomenal	raiva
formidável	raiva
forte	raiva
maravilhoso	raiva
em excesso	raiva
em demasia	raiva
além da conta	raiva
além da medida	raiva
além disso	raiva
além desse fato	raiva
além do mais	raiva
além de que	raiva
ademais	raiva
de mais a mais	raiva
aliás	raiva
outros	raiva
restantes	raiva
resto	raiva
mais	raiva
exuberante	raiva
excedente	raiva
hiperbólico	raiva
abusivo	raiva
por demais	raiva
supérfluo	raiva
desnecessário	raiva
dispensável	raiva
prescindível	raiva
escusado	raiva
redundante	raiva
desregrado	raiva
descontrolado	raiva
descomedido	raiva
imoderado	raiva
incontrolável	raiva
sobreposse	raiva
sobejamente	raiva
imoderadamente	raiva
fartamente	raiva
profusamente	raiva
verdadeiramente	raiva
totalmente	raiva
surpreendentemente	raiva
eminentemente	raiva
elevadamente	raiva
seriamente	raiva
fora	raiva
negativa	raiva
desacolhimento	raiva
preterição	raiva
repudiação	raiva
ostracismo	raiva
desaceitação	raiva
abstenção	raiva
desabrigo	raiva
desamparo	raiva
desarrimo	raiva
descuramento	raiva
esquecimento	raiva
desproteção	raiva
renunciação	raiva
descarte	raiva
inaptidão	raiva
incapacidade	raiva
impede	raiva
desconhece	raiva
indeferimento	raiva
afincamento	raiva
caturrice	raiva
obcecação	raiva
perrice	raiva
teimosice	raiva
turra	raiva
suposição	raiva
arbitrariedade	raiva
congeminação	raiva
discriminação	raiva
dissidência	raiva
preconceito	raiva
reincidência	raiva
grilo	raiva
revelia	raiva
contempla	raiva
implica	raiva
reflete	raiva
remói	raiva
emulação	raiva
nadinha	raiva
pouquinho	raiva
idiossincrasia	raiva
impavidez	raiva
raça	raiva
heroísmo	raiva
façanha	raiva
proeza	raiva
hombridade	raiva
braço	raiva
autoestima	raiva
ufania	raiva
entono	raiva
airosidade	raiva
liberalidade	raiva
munificência	raiva
branqueação	raiva
alvejamento	raiva
branqueamento	raiva
cora	raiva
coradouro	raiva
destemer	raiva
ardidez	raiva
arreganho	raiva
guapeza	raiva
possança	raiva
fígado	raiva
desmazelo	raiva
inadvertência	raiva
frigidez	raiva
gelo	raiva
algidez	raiva
frialdade	raiva
distância	raiva
neutralidade	raiva
frio	raiva
calo	raiva
friúra	raiva
regelo	raiva
mármore	raiva
neve	raiva
malbarato	raiva
desabono	raiva
xingamento	raiva
desvalimento	raiva
desafeto	raiva
longanimidade	raiva
emissão	raiva
abandonamento	raiva
deserção	raiva
evacuação	raiva
abdicação	raiva
cessão	raiva
desistência	raiva
entrega	raiva
humanitarismo	raiva
alheação	raiva
digressão	raiva
divagação	raiva
abstração	raiva
excurso	raiva
lamento	raiva
lamúria	raiva
queixume	raiva
gemido	raiva
ai	raiva
pranto	raiva
melúria	raiva
jeremiada	raiva
murmúrio	raiva
reclamação	raiva
protestação	raiva
reivindicação	raiva
denúncia	raiva
participação	raiva
acusação	raiva
delação	raiva
incriminação	raiva
criminação	raiva
inculpação	raiva
imputação	raiva
libelo	raiva
crítica	raiva
exprobação	raiva
sintoma	raiva
bile	raiva
amassado	raiva
amassadela	raiva
amassadura	raiva
amolgadela	raiva
amolgadura	raiva
amolgamento	raiva
impressão	raiva
entalhe	raiva
entalho	raiva
entalha	raiva
entalhamento	raiva
entalhadura	raiva
vestígio	raiva
aspirar	raiva
almejar	raiva
ambicionar	raiva
cobiçar	raiva
apetecer	raiva
anelar	raiva
pretender	raiva
tencionar	raiva
intencionar	raiva
intentar	raiva
planear	raiva
exigir	raiva
demandar	raiva
requerer	raiva
necessitar	raiva
precisar	raiva
carecer	raiva
preferir	raiva
optar	raiva
eleger	raiva
decidir-se	raiva
selecionar	raiva
escolher	raiva
dispor-se	raiva
oferecer-se	raiva
prestar-se	raiva
venerar	raiva
idolatrar	raiva
consentir	raiva
autorizar	raiva
deixar	raiva
concordar	raiva
conceder	raiva
anuir	raiva
benquerença	raiva
objetivo	raiva
sem querer	raiva
hipertermia	raiva
pirexia	raiva
temperatura	raiva
febre intermitente	raiva
impaludismo	raiva
malária	raiva
maleita	raiva
paludismo	raiva
sezão	raiva
sezões	raiva
sezonismo	raiva
chamego	raiva
fidelidade	raiva
metrópole	raiva
mãe	raiva
central	raiva
cerne	raiva
foco	raiva
seio	raiva
polo	raiva
catedral	raiva
sé	raiva
igreja	raiva
domo	raiva
assento	raiva
cadeira	raiva
banco	raiva
sexo	raiva
sexualidade	raiva
energia vital	raiva
finalidade	raiva
atento	raiva
esforçado	raiva
almejo	raiva
latejo	raiva
desiderato	raiva
espero	raiva
escopo	raiva
alvo	raiva
fito	raiva
meta	raiva
vista	raiva
mira	raiva
pensamento	raiva
lenda	raiva
mito	raiva
mitologia	raiva
cacoete	raiva
jeitão	raiva
bizarrice	raiva
estapafurdismo	raiva
exotismo	raiva
ratada	raiva
ratice	raiva
monomania	raiva
obumbração	raiva
telha	raiva
cachaça	raiva
vesânia	raiva
ideal	raiva
idealidade	raiva
boniteza	raiva
lindeza	raiva
batalhação	raiva
contumácia	raiva
instância	raiva
porfia	raiva
rebeldia	raiva
recalcitrância	raiva
rasgão	raiva
rasgadura	raiva
traço	raiva
encaixe	raiva
estria	raiva
vão	raiva
farpa	raiva
tirada	raiva
anterioridade	raiva
antecedência	raiva
primado	raiva
principalidade	raiva
prioridade	raiva
privilégio	raiva
preeminência	raiva
benquerança	raiva
culto	raiva
estusiasmo	raiva
namoro	raiva
relação	raiva
relacionamento	raiva
romance	raiva
acasalamento	raiva
ato sexual	raiva
amante	raiva
garoto	raiva
mina	raiva
namorado	raiva
xodó	raiva
hanseníase	raiva
lepra	raiva
malagueta	raiva
pimenta-do-reino	raiva
pimenta-malagueta	raiva
brejeirice	raiva
mordacidade	raiva
sal	raiva
afrodisia	raiva
erotismo	raiva
incontinência	raiva
sensualismo	raiva
voluptuosidade	raiva
arruaceiro	raiva
brigador	raiva
brigão	raiva
brigoso	raiva
briguento	raiva
colérico	raiva
genioso	raiva
provocador	raiva
rixento	raiva
valentão	raiva
ativo	raiva
azougue	raiva
foguete	raiva
burrinho	raiva
caga-fogo	raiva
potó	raiva
vaquinha	raiva
atordoamento	nojo
zonzeira	nojo
cinismo	nojo
defloramento	nojo
desfloração	nojo
estupro	nojo
superstição	nojo
crendice	nojo
abusão	nojo
pregação	nojo
tráfego	nojo
estafamento	nojo
maratona	nojo
lesco-lesco	nojo
abastamento	nojo
repleção	nojo
saturação	nojo
uniformidade	nojo
invariabilidade	nojo
inalterabilidade	nojo
ramerrão	nojo
unissonância	nojo
beberagem	nojo
eletuário	nojo
elixir	nojo
loque	nojo
medicamento	nojo
purgante	nojo
tisana	nojo
calda	nojo
aborrecido	nojo
aperreador	nojo
aperreante	nojo
aporrinhante	nojo
azucrinante	nojo
cacete	nojo
cansativo	nojo
chato	nojo
desagradável	nojo
enfadonho	nojo
enfastiante	nojo
enjoado	nojo
entediante	nojo
fastidioso	nojo
impertinente	nojo
implicante	nojo
importuno	nojo
irritante	nojo
maçador	nojo
maçante	nojo
maçudo	nojo
molesto	nojo
mortal	nojo
tedioso	nojo
livre	nojo
vago	nojo
desocupado	nojo
desguarnecido	nojo
desabitado	nojo
despovoado	nojo
aliviado	nojo
derramado	nojo
descarregado	nojo
despejado	nojo
entornado	nojo
esvaziado	nojo
vazado	nojo
carente	nojo
destituído	nojo
falto	nojo
privado	nojo
frívolo	nojo
fútil	nojo
oco	nojo
superficial	nojo
baldado	nojo
fracassado	nojo
frustrado	nojo
infrutífero	nojo
inútil	nojo
enganoso	nojo
fingido	nojo
hipócrita	nojo
mentiroso	nojo
vacuidade	nojo
insaciabilidade	nojo
abacaxi	nojo
imbróglio	nojo
embrulho	nojo
espeto	nojo
dilema	nojo
pergunta	nojo
enigma	nojo
mistério	nojo
incógnita	nojo
charada	nojo
pepineiro	nojo
fumaça	nojo
vapor	nojo
tabagismo	nojo
charuto	nojo
cigarrilha	nojo
cigarro	nojo
pitura	nojo
tabaco	nojo
diamba	nojo
efemeridade	nojo
exalação	nojo
miasma	nojo
fanfarrice	nojo
jactância	nojo
prosápia	nojo
soberba	nojo
vanglória	nojo
gravame	nojo
comprometimento	nojo
escória	nojo
difamação	nojo
sarjeta	nojo
nódoa	nojo
borrão	nojo
estigma	nojo
enxovalhamento	nojo
aviltação	nojo
envilecimento	nojo
opróbio	nojo
deságio	nojo
jaça	nojo
poluição	nojo
acanho	nojo
bisonharia	nojo
bisonhice	nojo
encalistração	nojo
encalistramento	nojo
encolha	nojo
inibição	nojo
curteza	nojo
atamento	nojo
retração	nojo
esquivança	nojo
penumbra	nojo
reservação	nojo
estoque	nojo
encomenda	nojo
pedido	nojo
solicitação	nojo
mata	nojo
parque	nojo
reservo	nojo
território	nojo
cláusula	nojo
condicionante	nojo
exceção	nojo
ressalva	nojo
suplente	nojo
substituto	nojo
economias	nojo
poupanças	nojo
riquezas	nojo
valores	nojo
tropa	nojo
estepe	nojo
sobressalente	nojo
sobresselente	nojo
recolhida	nojo
clausura	nojo
encarceramento	nojo
concentração	nojo
apanha	nojo
colheita	nojo
arrecadação	nojo
pesquisa	nojo
encerramento	nojo
resgate	nojo
cobrança	nojo
ninho	nojo
quarentena	nojo
recebimento	nojo
introspecção	nojo
coleta	nojo
recuo	nojo
retrocesso	nojo
abreviação	nojo
rarefação	nojo
vermelhidão	nojo
vermelhão	nojo
enrubescimento	nojo
ruborização	nojo
afogueamento	nojo
postura	nojo
equidade	nojo
justiça	nojo
virgindade	nojo
candura	nojo
continência	nojo
simplicidade	nojo
sobriedade	nojo
temperança	nojo
despojamento	nojo
santidade	nojo
espiritualidade	nojo
transcendência	nojo
em virtude de	nojo
em virtude	nojo
sisudez	nojo
lealdade	nojo
honorabilidade	nojo
honraria	nojo
destaque	nojo
relevo	nojo
elogio	nojo
laurel	nojo
encômio	nojo
regalia	nojo
prerrogativa	nojo
apanágio	nojo
virtuosidade	nojo
título	nojo
cargo	nojo
posto	nojo
formalidade	nojo
imodéstia	nojo
empáfia	nojo
desvanecimento	nojo
alarde	nojo
fatuidade	nojo
filáucia	nojo
inteireza	nojo
completude	nojo
totalidade	nojo
unidade	nojo
inatingibilidade	nojo
intangibilidade	nojo
intatilidade	nojo
sinceridade	nojo
limpidez	nojo
lucidez	nojo
transparência	nojo
autenticidade	nojo
genuinidade	nojo
casticismo	nojo
puridade	nojo
purismo	nojo
vernaculidade	nojo
homogeneidade	nojo
naturalidade	nojo
desadorno	nojo
espontaneidade	nojo
nudez	nojo
parcimônia	nojo
bonomia	nojo
lhanura	nojo
simplismo	nojo
acautelamento	nojo
alerta	nojo
caução	nojo
olho	nojo
recibo	nojo
certificado	nojo
décimo	nojo
gasparinho	nojo
conta	nojo
aprimorado	nojo
caprichado	nojo
esmerado	nojo
impecável	nojo
perfeito	nojo
primoroso	nojo
meditado	nojo
pensado	nojo
ponderado	nojo
refletido	nojo
calculado	nojo
esperado	nojo
previsto	nojo
proposital	nojo
intencional	nojo
propositado	nojo
premeditado	nojo
deliberado	nojo
delgadeza	nojo
tenuidade	nojo
acume	nojo
tropelia	nojo
particularidade	nojo
pormenor	nojo
indireta	nojo
insinuação	nojo
estoicismo	nojo
estoicidade	nojo
frugalidade	nojo
autarcia	nojo
autodomínio	nojo
têmpera	nojo
exigência	nojo
inexorabilidade	nojo
crimeza	nojo
rigorismo	nojo
inexperiência	nojo
infantilidade	nojo
criancice	nojo
candidez	nojo
risca	nojo
listra	nojo
fiada	nojo
correnteza	nojo
carreira	nojo
ala	nojo
fieira	nojo
renque	nojo
amarra	nojo
amarrilho	nojo
atilho	nojo
barbante	nojo
corda	nojo
cordão	nojo
cordel	nojo
correia	nojo
fio	nojo
guita	nojo
caminho de ferro	nojo
carril	nojo
estrada de ferro	nojo
ferrovia	nojo
linha férrea	nojo
trilho	nojo
via férrea	nojo
design	nojo
modelagem	nojo
diretriz	nojo
diretrizes	nojo
norma	nojo
normas	nojo
orientação	nojo
regras	nojo
esbeltez	nojo
esbelteza	nojo
esguiez	nojo
feições	nojo
formas	nojo
traços	nojo
comportamentos	nojo
costumes	nojo
particularidades	nojo
sistemas	nojo
procedimentos	nojo
ferramentas	nojo
práticas	nojo
técnicas	nojo
mecanismos	nojo
atitudes	nojo
métodos	nojo
processos	nojo
termos	nojo
estratégias	nojo
dispositivos	nojo
situações	nojo
caminhos	nojo
tipos	nojo
eufemismo	nojo
economia	nojo
meio-termo	nojo
morigeração	nojo
autocontrole	nojo
cachimônia	nojo
características	nojo
atributos	nojo
peculiaridades	nojo
boa-fé	nojo
franqueza	nojo
veracidade	nojo
verdade	nojo
arrebentação	nojo
aristocracia	nojo
fidalguia	nojo
nobiliarquia	nojo
alta	nojo
alteza	nojo
realce	nojo
elite	nojo
levantamento	nojo
conspicuidade	nojo
alta-roda	nojo
merecimento	nojo
impedição	nojo
veto	nojo
travanca	nojo
tranca	nojo
impeachment	nojo
exoneração	nojo
banheira	nojo
reprovação	nojo
desaprovação	nojo
entrevação	nojo
entrevamento	nojo
apertão	nojo
arrocho	nojo
assédio	nojo
cerco	nojo
desfiladeiro	nojo
angustura	nojo
garganta	nojo
estreito	nojo
afinamento	nojo
seringação	nojo
mocada	nojo
paulada	nojo
ripada	nojo
lambada	nojo
porretada	nojo
tacada	nojo
queimação	nojo
embuste	nojo
fraude	nojo
burla	nojo
estiagem	nojo
estio	nojo
verão	nojo
madrasta	nojo
estupefação	medo
estuporação	medo
brado	medo
rebate	medo
celeuma	medo
repique	medo
acatamento	medo
atendimento	medo
observação	medo
subordinação	medo
referência	medo
perspectiva	medo
ângulo	medo
ponto de vista	medo
prisma	medo
homenagens	medo
a respeito de	medo
a respeito	medo
no que diz respeito	medo
diz respeito	medo
dizer respeito a	medo
no que diz respeito a	medo
roldão	medo
nervosismo	medo
ralação	medo
nervoso	medo
tempestade	medo
prurido	medo
turbação	medo
formigueiro	medo
tremido	medo
vibração	medo
arrepio	medo
calafrio	medo
horripilação	medo
balismo	medo
palpitação	medo
tremedeira	medo
trêmulo	medo
assiduidade	medo
exação	medo
empenhamento	medo
notoriedade	medo
pistolão	medo
cartucho	medo
mediação	medo
cunha	medo
penhora	medo
penhor	medo
hipoteca	medo
engajamento	medo
imaleabilidade	medo
transição	medo
pinote	medo
pulo	medo
bote	medo
passada	medo
corcovo	medo
tacão	medo
gritaria	medo
berreiro	medo
calvície	medo
alopecia	medo
premonição	medo
presciência	medo
previsão	medo
divinação	medo
feeling	medo
hipótese	medo
conjectura	medo
pressuposto	medo
questionável	medo
contestável	medo
discutível	medo
suspicaz	medo
inquietante	medo
arquejamento	medo
arfagem	medo
rouquidão	medo
paroxismo	medo
questionamento	medo
ambivalência	medo
anfibolia	medo
anfibologia	medo
dubieza	medo
perplexão	medo
titubeação	medo
titubeio	medo
desvalor	medo
poltroneria	medo
cintilante	medo
cintilar	medo
faiscante	medo
faiscar	medo
fulgurar	medo
frescura	medo
impermanência	medo
perecibilidade	medo
transitoriedade	medo
estiolamento	medo
atrofiamento	medo
héctica	medo
tísica	medo
hética	medo
esfalfação	medo
esfalfe	medo
irritabilidade	medo
tepidez	medo
trinca	medo
inexistência	medo
pouquidade	medo
exiguidade	medo
prevaricação	medo
trivialidade	medo
pleonasmo	medo
inocuidade	medo
desnecessidade	medo
erupção	medo
borrifo	medo
furúnculo	medo
impureza	medo
inquinação	medo
laivo	medo
mata-borrão	medo
pinta	medo
respingo	medo
tacha	medo
sujo	medo
contaminação	medo
mascarra	medo
roxo	medo
tara	medo
lambuzadela	medo
roxa	medo
destrutibilidade	medo
indefensibilidade	medo
detalhe	medo
palor	medo
palescência	medo
esqualidez	medo
lividez	medo
