	0
alegria	alegria
antecipação	antecipação
confiança	confiança
medo	medo
nojo	nojo
raiva	raiva
surpresa	surpresa
tristeza	tristeza
contentamento	alegria
precipitação	antecipação
firmeza	confiança
pavor	medo
asco	nojo
fúria	raiva
espanto	surpresa
infelicidade	tristeza
satisfação	alegria
previsão	antecipação
segurança	confiança
fobia	medo
aversão	nojo
ira	raiva
admiração	surpresa
desânimo	tristeza
felicidade	alegria
profecia	antecipação
certeza	confiança
horror	medo
náusea	nojo
cólera	raiva
assombro	surpresa
tristura	tristeza
prazer	alegria
presságio	antecipação
convicção	confiança
terror	medo
enjoo	nojo
irritação	raiva
pasmo	surpresa
descontentamento	tristeza
regozijo	alegria
adiantamento	antecipação
força	confiança
pânico	medo
repugnância	nojo
ódio	raiva
maravilha	surpresa
abatimento	tristeza
júbilo	alegria
avanço	antecipação
fé	confiança
temor	medo
repulsão	nojo
gana	raiva
maravilhamento	surpresa
melancolia	tristeza
riso	alegria
abreviação	antecipação
crença	confiança
susto	medo
repulsa	nojo
furor	raiva
sobressalto	surpresa
desalento	tristeza
bom humor	alegria
prevenção	antecipação
esperança	confiança
ojeriza	medo
fastio	nojo
zanga	raiva
abalo	surpresa
desolação	tristeza
agrado	alegria
predição	antecipação
otimismo	confiança
amedrontamento	medo
abominação	nojo
agressividade	raiva
choque	surpresa
desconsolo	tristeza
regalo	alegria
prolepse	antecipação
familiaridade	confiança
receio	medo
animosidade	nojo
sanha	raiva
comoção	surpresa
insatisfação	tristeza
animação	alegria
antevisão	antecipação
informalidade	confiança
apreensão	medo
enojo	nojo
exasperação	raiva
perturbação	surpresa
esmorecimento	tristeza
gosto	alegria
imaturidade	antecipação
intimidade	confiança
preocupação	medo
engulho	nojo
frustração	raiva
emoção	surpresa
prostração	tristeza
bem-estar	alegria
anástrofe	antecipação
boa fama	confiança
ansiedade	medo
antojo	nojo
indignação	raiva
estranheza	surpresa
depressão	tristeza
comprazimento	alegria
hipérbato	antecipação
boa reputação	confiança
inquietação	medo
luto	nojo
antipatia	raiva
espavento	surpresa
desesperança	tristeza
contento	alegria
sínquise	antecipação
confiabilidade	confiança
incerteza	medo
dó	nojo
odiosidade	raiva
fascínio	surpresa
mágoa	tristeza
deleite	alegria
previsibilidade	antecipação
credibilidade	confiança
dúvida	medo
pesar	nojo
execração	raiva
imprevisto	surpresa
desgosto	tristeza
euforia	alegria
leviandade	antecipação
estabilidade	confiança
fraqueza	medo
ânsia	nojo
frenesi	raiva
estupefação	surpresa
azar	tristeza
alacridade	alegria
irreflexão	antecipação
solidez	confiança
desprezo	medo
mal-estar	nojo
impetuosidade	raiva
perplexidade	surpresa
desgraça	tristeza
aprazimento	alegria
impaciência	antecipação
fixidez	confiança
alarma	medo
repelência	nojo
repelo	raiva
estuporação	surpresa
fatalidade	tristeza
desfastio	alegria
urgência	antecipação
imobilidade	confiança
cagaço	medo
rancor	nojo
violência	raiva
estranhez	surpresa
desdita	tristeza
entusiasmo	alegria
açodamento	antecipação
equilíbrio	confiança
estarrecimento	medo
animadversão	nojo
onda	raiva
confusão	surpresa
desventura	tristeza
jovialidade	alegria
atrapalhação	antecipação
permanência	confiança
intolerância	medo
desafeto	nojo
alteração	raiva
alvoroço	surpresa
infortúnio	tristeza
jubilidade	alegria
azáfama	antecipação
determinação	confiança
crueldade	medo
embirração	nojo
aborrecimento	raiva
arrebatamento	surpresa
misantropia	tristeza
ledice	alegria
imprudência	antecipação
resolução	confiança
monstruosidade	medo
hostilidade	nojo
loucura	raiva
sensação	surpresa
aborto	tristeza
desculpa	alegria
pressa	antecipação
decisão	confiança
barbaridade	medo
inimizade	nojo
impulso	raiva
deslumbramento	surpresa
mal	tristeza
escusa	alegria
agonia	antecipação
fortaleza	confiança
atrocidade	medo
malquerença	nojo
ímpeto	raiva
deslumbre	surpresa
adversidade	tristeza
justificativa	alegria
afoiteza	antecipação
impassibilidade	confiança
hediondez	medo
malquerer	nojo
borrasca	raiva
encantamento	surpresa
calamidade	tristeza
motivo	alegria
temeridade	antecipação
coragem	confiança
selvajaria	medo
abuso	nojo
exaltação	raiva
encanto	surpresa
catástrofe	tristeza
razão	alegria
facilidade	antecipação
desassombro	confiança
desumanidade	medo
estuação	nojo
excitação	raiva
êxtase	surpresa
revés	tristeza
explicação	alegria
agitação	antecipação
deliberação	confiança
bestialidade	medo
revolução	nojo
acromania	raiva
fascinação	surpresa
tragédia	tristeza
compensação	alegria
apuro	antecipação
precisão	confiança
crime	medo
entojo	nojo
assanhamento	raiva
respeito	surpresa
aflição	tristeza
devolução	alegria
aturdimento	antecipação
energia	confiança
feiura	medo
afronta	nojo
danação	raiva
consideração	surpresa
tormento	tristeza
indenização	alegria
criancice	antecipação
persistência	confiança
monstro	medo
naupatia	nojo
embravecimento	raiva
veneração	surpresa
sofrimento	tristeza
paga	alegria
criançada	antecipação
perseverança	confiança
bicho	medo
peso	nojo
encarniçamento	raiva
adoração	surpresa
mesquinhez	tristeza
pagamento	alegria
descuido	antecipação
constância	confiança
diabo	medo
tontura	nojo
estrilo	raiva
afeição	surpresa
contratempo	tristeza
recompensa	alegria
inadvertência	antecipação
insistência	confiança
mostrengo	medo
enfado	nojo
repente	raiva
apreço	surpresa
intempérie	tristeza
reembolso	alegria
movimento	antecipação
obstinação	confiança
canhão	medo
enfaro	nojo
rompante	raiva
contemplação	surpresa
castigo	tristeza
remuneração	alegria
maluqueira	antecipação
aplicação	confiança
bruxa	medo
tédio	nojo
veemência	raiva
deferência	surpresa
volta	tristeza
ressarcimento	alegria
maluquice	antecipação
vontade	confiança
bruaca	medo
resistência	nojo
voracidade	raiva
estima	surpresa
lástima	tristeza
restituição	alegria
aceleração	antecipação
afinco	confiança
xaveco	medo
oposição	nojo
tesão	raiva
simpatia	surpresa
golpe	tristeza
retribuição	alegria
afobação	antecipação
ânimo	confiança
bagulho	medo
objeção	nojo
elã	raiva
assombração	surpresa
derrota	tristeza
desagravo	alegria
afogadilho	antecipação
assiduidade	confiança
jararaca	medo
revolta	nojo
pena	raiva
visão	surpresa
dissabor	tristeza
expiação	alegria
apressuramento	antecipação
consistência	confiança
bucho	medo
dificuldade	nojo
punição	raiva
atordoamento	surpresa
sorte	tristeza
reparação	alegria
estouvamento	antecipação
instância	confiança
desagrado	medo
torpeza	nojo
vingança	raiva
fantasma	surpresa
negrura	tristeza
retratação	alegria
insensatez	antecipação
estoicidade	confiança
desprazer	medo
rejeição	nojo
cólera-morbo	raiva
fenômeno	surpresa
negrume	tristeza
bem-aventurança	alegria
roldão	antecipação
paciência	confiança
contrariedade	medo
esquivança	nojo
mordexim	raiva
aparição	surpresa
miséria	tristeza
ventura	alegria
esparolação	antecipação
tenacidade	confiança
amofinação	medo
repúdio	nojo
descontrole	raiva
espetáculo	surpresa
sentimento	tristeza
dita	alegria
irresponsabilidade	antecipação
disciplina	confiança
dor	medo
escândalo	nojo
exacerbação	raiva
milagre	surpresa
moleza	tristeza
fortuna	alegria
leveza	antecipação
porfia	confiança
padecimento	medo
expulsão	nojo
feridade	raiva
pasmaceira	surpresa
atribulação	tristeza
sucesso	alegria
prognóstico	antecipação
robustez	confiança
dinheirão	medo
repressão	nojo
fereza	raiva
prodígio	surpresa
caiporismo	tristeza
êxito	alegria
vaticínio	antecipação
vigor	confiança
dinheirada	medo
recalque	nojo
braveza	raiva
estupefato	surpresa
casmurrice	tristeza
triunfo	alegria
prenúncio	antecipação
tenência	confiança
dinheirama	medo
asca	nojo
ferocidade	raiva
boquiaberto	surpresa
hipocondria	tristeza
vitória	alegria
prognose	antecipação
rijeza	confiança
exorbitância	medo
enjeitamento	nojo
flagelo	raiva
pasmado	surpresa
insucesso	tristeza
acerto	alegria
premonição	antecipação
rigidez	confiança
batelada	medo
entejo	nojo
mau	raiva
admirado	surpresa
macaca	tristeza
glória	alegria
presciência	antecipação
dureza	confiança
monte	medo
estranhamento	nojo
praga	raiva
espantado	surpresa
mofina	tristeza
congratulações	alegria
augúrio	antecipação
autoconfiança	confiança
montão	medo
contestação	nojo
nervosismo	raiva
estupefacto	surpresa
morrinha	tristeza
felicitações	alegria
intuição	antecipação
afirmação	confiança
quantidade	medo
denegação	nojo
neurastenia	raiva
perplexo	surpresa
suicídio	tristeza
cumprimentos	alegria
pressentimento	antecipação
autoafirmação	confiança
abundância	medo
divergência	nojo
estresse	raiva
surpreendido	surpresa
taciturnidade	tristeza
exultação	alegria
suspeita	antecipação
garantia	confiança
enxurrada	medo
impugnação	nojo
stress	raiva
surpreso	surpresa
transtorno	tristeza
gáudio	alegria
suposição	antecipação
caução	confiança
porção	medo
nega	nojo
droga	raiva
absorto	surpresa
urucubaca	tristeza
jubilação	alegria
conjectura	antecipação
fiança	confiança
profusão	medo
negaça	nojo
grosseiro	raiva
embasbacado	surpresa
vicissitude	tristeza
deleitação	alegria
hipótese	antecipação
penhor	confiança
série	medo
negação	nojo
agastamento	raiva
atônito	surpresa
zica	tristeza
deleitamento	alegria
pressuposição	antecipação
proteção	confiança
chorrilho	medo
negamento	nojo
azedume	raiva
portento	surpresa
tanglomanglo	tristeza
delícia	alegria
presunção	antecipação
defesa	confiança
mundo	medo
recusa	nojo
birra	raiva
colosso	surpresa
malemolência	tristeza
desejo	alegria
palpite	antecipação
salvaguarda	confiança
mundaréu	medo
refusão	nojo
perrice	raiva
embevecimento	surpresa
acabrunhamento	tristeza
distração	alegria
estimativa	antecipação
resguardo	confiança
amontoado	medo
refutação	nojo
nervoso	raiva
enlevo	surpresa
apatia	tristeza
diversão	alegria
orçamento	antecipação
cuidado	confiança
intensamente	medo
anorexia	nojo
aperreação	raiva
perfeição	surpresa
arrefecimento	tristeza
divertimento	alegria
cálculo	antecipação
preservação	confiança
muito	medo
cansaço	nojo
desespero	raiva
primor	surpresa
debilidade	tristeza
entretenimento	alegria
avaliação	antecipação
infalibilidade	confiança
bastante	medo
canseira	nojo
estorvo	raiva
correção	surpresa
derrotismo	tristeza
passatempo	alegria
estimação	antecipação
precaução	confiança
imenso	medo
fadiga	nojo
desconfiança	raiva
impecabilidade	surpresa
desconforto	tristeza
recreação	alegria
cômputo	antecipação
prudência	confiança
demais	medo
inapetência	nojo
acirramento	raiva
calêndula	surpresa
desinteresse	tristeza
gozo	alegria
cautela	antecipação
seguro	confiança
demasiado	medo
quebreira	nojo
apoquentação	raiva
dengue	surpresa
desvalor	tristeza
satisfazer	alegria
aviso	antecipação
reserva	confiança
demasiadamente	medo
sufocação	nojo
apuração	raiva
amor	surpresa
esgotamento	tristeza
comprazer	alegria
sobreaviso	antecipação
amparo	confiança
excessivamente	medo
saciedade	nojo
apuramento	raiva
paixão	surpresa
esvaecimento	tristeza
aprazer	alegria
advertência	antecipação
esteio	confiança
exageradamente	medo
displicência	nojo
arrelia	raiva
sedução	surpresa
frieza	tristeza
agradar	alegria
providência	antecipação
guarda-costas	confiança
tremor	medo
monotonia	nojo
arrenegação	raiva
prisão	surpresa
frio	tristeza
doçura	alegria
previdência	antecipação
guardião	confiança
caguira	medo
xarope	nojo
assomo	raiva
interesse	surpresa
indiferença	tristeza
complacência	alegria
diligência	antecipação
satélite	confiança
sobrosso	medo
anátema	nojo
aziúme	raiva
ofuscação	surpresa
inércia	tristeza
festa	alegria
oráculo	antecipação
vigilante	confiança
reverência	medo
abomínio	nojo
baba	raiva
denguice	surpresa
languidez	tristeza
aleluia	alegria
pressuposto	antecipação
vigia	confiança
obediência	medo
ressentimento	nojo
despeito	raiva
imã	surpresa
letargia	tristeza
rejubilação	alegria
horoscópio	antecipação
guarda	confiança
desassossego	medo
ardor	nojo
escamação	raiva
charme	surpresa
modorra	tristeza
sol	alegria
horóscopo	antecipação
sentinela	confiança
inquietude	medo
calor	nojo
fel	raiva
dengo	surpresa
preguiça	tristeza
rejúbilo	alegria
adivinhação	antecipação
acertamento	confiança
ameaça	medo
fervor	nojo
focagem	raiva
atração	surpresa
pusilanimidade	tristeza
empolgação	alegria
anúncio	antecipação
asserção	confiança
pontualidade	medo
arrojo	nojo
lua	raiva
atratividade	surpresa
remissão	tristeza
letícia	alegria
agouro	antecipação
asseveração	confiança
zelo	medo
audácia	nojo
calundu	raiva
glamour	surpresa
tepidez	tristeza
sorriso	alegria
divinação	antecipação
evidência	confiança
empenho	medo
bravura	nojo
torvação	raiva
carisma	surpresa
tibieza	tristeza
zombaria	alegria
sinal	antecipação
indubitabilidade	confiança
rigor	medo
brio	nojo
mau humor	raiva
impacto	surpresa
viuvez	tristeza
gargalhada	alegria
indício	antecipação
veracidade	confiança
escrúpulo	medo
disposição	nojo
implicação	raiva
desordem	surpresa
consternação	tristeza
gozação	alegria
indicação	antecipação
persuasão	confiança
salto	medo
intrepidez	nojo
implicância	raiva
bagunça	surpresa
decepção	tristeza
chacota	alegria
auspício	antecipação
convencimento	confiança
tremura	medo
ousadia	nojo
malevolência	raiva
alarme	surpresa
inconformação	tristeza
ridículo	alegria
sintoma	antecipação
com certeza	confiança
peladura	medo
valentia	nojo
garra	raiva
suspiro	surpresa
desprazimento	tristeza
hilaridade	alegria
bacorejo	antecipação
sugestionamento	confiança
acovardamento	medo
enojamento	nojo
anseio	raiva
trepidação	surpresa
malgrado	tristeza
risada	alegria
melhoria	antecipação
princípio	confiança
intranquilidade	medo
chateação	nojo
avidez	raiva
estremecimento	surpresa
abate	tristeza
judiaria	alegria
melhora	antecipação
ideia	confiança
intimidação	medo
ambição	nojo
sofreguidão	raiva
balanço	surpresa
nirvana	tristeza
judiação	alegria
dianteira	antecipação
ideal	confiança
angústia	medo
vazio	nojo
fome	raiva
oscilação	surpresa
baixa	tristeza
consentimento	alegria
vantagem	antecipação
ideologia	confiança
consumição	medo
morte	nojo
apetite	raiva
sacudida	surpresa
rebaixamento	tristeza
concordância	alegria
progresso	antecipação
concepção	confiança
mortificação	medo
anojamento	nojo
arroubo	raiva
sacudidela	surpresa
enfraquecimento	tristeza
anuência	alegria
prosperidade	antecipação
conceito	confiança
hesitação	medo
solda	nojo
acesso	raiva
abalamento	surpresa
abaixamento	tristeza
aprovação	alegria
desenvolvimento	antecipação
opinião	confiança
suspeição	medo
noite	nojo
moda	raiva
estremeção	surpresa
dedução	tristeza
permissão	alegria
aperfeiçoamento	antecipação
valor	confiança
cisma	medo
cipreste	nojo
voga	raiva
frêmito	surpresa
desconto	tristeza
assentimento	alegria
aumento	antecipação
juízo	confiança
captação	medo
crepe	nojo
amolação	raiva
abalada	surpresa
diminuição	tristeza
aquiescência	alegria
vale	antecipação
pensamento	confiança
assimilação	medo
condoimento	nojo
enguiço	raiva
debandada	surpresa
humilhação	tristeza
aceitação	alegria
civilização	antecipação
consciência	confiança
entendimento	medo
compadecimento	nojo
feitiço	raiva
fuga	surpresa
palerma	tristeza
beneplácito	alegria
crescimento	antecipação
enforcamento	confiança
percepção	medo
compaixão	nojo
mau-olhado	raiva
retirada	surpresa
caimento	tristeza
cortesia	alegria
proveito	antecipação
cadafalso	confiança
absorção	medo
piedade	nojo
quebranto	raiva
partida	surpresa
decadência	tristeza
educação	alegria
aproveitamento	antecipação
patíbulo	confiança
compreensão	medo
comiseração	nojo
incompatibilidade	raiva
saída	surpresa
declínio	tristeza
gentileza	alegria
evolução	antecipação
guilhotina	confiança
apoderamento	medo
constrição	nojo
enfurecimento	raiva
movimentação	surpresa
ruína	tristeza
delicadeza	alegria
indiscrição	antecipação
ardil	confiança
apoderação	medo
enternecimento	nojo
briga	raiva
baque	surpresa
escuridão	tristeza
cordialidade	alegria
melhoramento	antecipação
armadilha	confiança
apresamento	medo
miseração	nojo
desavença	raiva
tranco	surpresa
baixeza	tristeza
amabilidade	alegria
avançamento	antecipação
cilada	confiança
aprisionamento	medo
misericórdia	nojo
luta	raiva
ataque	surpresa
anemia	tristeza
graciosidade	alegria
avançada	antecipação
emboscada	confiança
apropriação	medo
abalançar	nojo
rixa	raiva
moção	surpresa
astenia	tristeza
afabilidade	alegria
frente	antecipação
laço	confiança
arresto	medo
romanear	nojo
avaria	raiva
desinquietação	surpresa
estrago	tristeza
urbanidade	alegria
vanguarda	antecipação
ancinho	confiança
captura	medo
sopesar	nojo
defeito	raiva
debilitação	surpresa
fossa	tristeza
fineza	alegria
ascensão	antecipação
forquilha	confiança
confiscação	medo
avaliar	nojo
falha	raiva
quebra	surpresa
diferença	tristeza
lhaneza	alegria
progressão	antecipação
garfo	confiança
confisco	medo
apreciar	nojo
agressão	raiva
depauperamento	surpresa
redução	tristeza
atenção	alegria
melhorada	antecipação
forcado	confiança
detenção	medo
analisar	nojo
hostilização	raiva
dissuasão	surpresa
desgaste	tristeza
gratificação	alegria
upgrade	antecipação
forqueta	confiança
embargo	medo
considerar	nojo
ofensa	raiva
tumulto	surpresa
matança	tristeza
prêmio	alegria
ampliação	antecipação
botequim	confiança
sequestro	medo
estimar	nojo
brutalidade	raiva
convulsão	surpresa
lentidão	tristeza
gorjeta	alegria
acréscimo	antecipação
vendinha de roça	confiança
afligimento	medo
estudar	nojo
belicosidade	raiva
efervescência	surpresa
frouxidão	tristeza
presente	alegria
acrescentamento	antecipação
credo	confiança
tormenta	medo
examinar	nojo
dinamismo	raiva
terremoto	surpresa
torpor	tristeza
favor	alegria
abreviatura	antecipação
credulidade	confiança
atormentamento	medo
observar	nojo
empreendimento	raiva
sismo	surpresa
opressão	tristeza
caixinha	alegria
sigla	antecipação
dogma	confiança
dedicação	medo
ponderar	nojo
atividade	raiva
cataclismo	surpresa
aniquilamento	tristeza
galardão	alegria
acrônimo	antecipação
doutrina	confiança
esmero	medo
presumir	nojo
recrudescimento	raiva
abalroamento	surpresa
atimia	tristeza
carinhos	alegria
miniatura	antecipação
religião	confiança
capricho	medo
imaginar	nojo
desapontamento	raiva
batida	surpresa
derrubada	tristeza
afagos	alegria
contração	antecipação
crédito	confiança
solicitude	medo
calcular	nojo
desaponto	raiva
abalroação	surpresa
descaimento	tristeza
festas	alegria
encolhimento	antecipação
fidúcia	confiança
desvelo	medo
conjecturar	nojo
desencanto	raiva
colisão	surpresa
desvalorização	tristeza
festinhas	alegria
encurtamento	antecipação
fieza	confiança
devoção	medo
prever	nojo
desencantamento	raiva
concussão	surpresa
lombeira	tristeza
mimos	alegria
resumo	antecipação
fiúza	confiança
obsessão	medo
supor	nojo
desilusão	raiva
embate	surpresa
marasmo	tristeza
brinco-de-princesa	alegria
síntese	antecipação
insuspeição	confiança
fixação	medo
influenciar	nojo
fracasso	raiva
encontrão	surpresa
morbidez	tristeza
lágrima	alegria
sumário	antecipação
comprovação	confiança
compulsão	medo
atuar	nojo
malogro	raiva
encontro	surpresa
nostalgia	tristeza
brinde	alegria
compêndio	antecipação
confirmação	confiança
obcecação	medo
induzir	nojo
falhanço	raiva
esbarrão	surpresa
quebradeira	tristeza
oferta	alegria
resenha	antecipação
corroboração	confiança
fanatismo	medo
influir	nojo
naufrágio	raiva
esbarro	surpresa
quebramento	tristeza
agasalho	alegria
epílogo	antecipação
demostração	confiança
mania	medo
instigar	nojo
antagonismo	raiva
pancada	surpresa
quebrantamento	tristeza
dádiva	alegria
epítome	antecipação
prova	confiança
preconceito	medo
intervir	nojo
desafeição	raiva
recontro	surpresa
amortização	tristeza
mimo	alegria
súmula	antecipação
ratificação	confiança
prejulgamento	medo
motivar	nojo
pontinha	raiva
solavanco	surpresa
bônus	tristeza
lembrança	alegria
medida	antecipação
testemunho	confiança
discriminação	medo
sugestionar	nojo
quizília	raiva
topada	surpresa
inanição	tristeza
volúpia	alegria
premeditação	antecipação
validação	confiança
estereótipo	medo
recair	nojo
teiró	raiva
toque	surpresa
subtração	tristeza
bobagem	alegria
preparação	antecipação
verificação	confiança
prejuízo	medo
incidir	nojo
alergia	raiva
trombada	surpresa
umbigo	tristeza
comodidade	alegria
preparativo	antecipação
compromisso	confiança
prenoção	medo
apertar	nojo
contragosto	raiva
conflito	surpresa
decremento	tristeza
prenda	alegria
preparo	antecipação
promessa	confiança
antepaixão	medo
calcar	nojo
quizila	raiva
desentendimento	surpresa
depleção	tristeza
vibração	alegria
cismo	antecipação
legitimidade	confiança
arquejo	medo
estender-se	nojo
imprecação	raiva
discussão	surpresa
adelgaçamento	tristeza
calma	alegria
inobservância	antecipação
durabilidade	confiança
adinamia	medo
afã	nojo
delírio	raiva
entorpecimento	surpresa
azarão	tristeza
conforto	alegria
inconsideração	antecipação
continuidade	confiança
fragilidade	medo
almejo	nojo
alucinação	raiva
adormecimento	surpresa
baldão	tristeza
despreocupação	alegria
inconstância	antecipação
duração	confiança
atonia	medo
anelo	nojo
devaneio	raiva
dormência	surpresa
acaso	tristeza
tranquilidade	alegria
inconsequência	antecipação
imutabilidade	confiança
definhamento	medo
comichão	nojo
correria	raiva
embaraço	surpresa
acontecimento	tristeza
oásis	alegria
desatenção	antecipação
invariabilidade	confiança
depauperação	medo
necessidade	nojo
intensidade	raiva
perplexão	surpresa
casualidade	tristeza
prazimento	alegria
negligência	antecipação
manutenção	confiança
desfalecimento	medo
sede	nojo
vivacidade	raiva
indecisão	surpresa
evento	tristeza
amenidade	alegria
incúria	antecipação
subsistência	confiança
esfalfamento	medo
esforço	nojo
aspereza	raiva
irresolução	surpresa
eventualidade	tristeza
sanção	alegria
futilidade	antecipação
controle	confiança
extenuação	medo
usura	nojo
selvageria	raiva
vacilação	surpresa
ocorrência	tristeza
desenfado	alegria
frivolidade	antecipação
harmonia	confiança
fraqueira	medo
vasca	nojo
inflamação	raiva
inação	surpresa
acarretar	tristeza
jucundidade	alegria
superficialidade	antecipação
imperturbabilidade	confiança
acobardamento	medo
arranque	nojo
irritabilidade	raiva
indefinição	surpresa
causar	tristeza
pasto	alegria
veleidade	antecipação
moderação	confiança
cobardia	medo
arranco	nojo
iracúndia	raiva
dubiedade	surpresa
ocasionar	tristeza
flama	alegria
ligeireza	antecipação
serenidade	confiança
covardia	medo
arfagem	nojo
irascibilidade	raiva
dilema	surpresa
originar	tristeza
vida	alegria
ligeirice	antecipação
densidade	confiança
desbrio	medo
estertor	nojo
cerceamento	raiva
titubeação	surpresa
provocar	tristeza
frenesim	alegria
puerilidade	antecipação
concreção	confiança
ignávia	medo
anelação	nojo
coação	raiva
titubeio	surpresa
perda	tristeza
centelha	alegria
doideira	antecipação
espessura	confiança
poltronaria	medo
cirro	nojo
coerção	raiva
enleio	surpresa
tribulação	tristeza
estro	alegria
esquecimento	antecipação
grossura	confiança
poltronice	medo
ofego	nojo
coibição	raiva
bizarria	surpresa
desaire	tristeza
iluminação	alegria
aperto	antecipação
encorpadura	confiança
tibiez	medo
paroxismo	nojo
constrangimento	raiva
esquisitice	surpresa
drama	tristeza
inspiração	alegria
prurido	antecipação
endurecimento	confiança
timidez	medo
piada	nojo
imposição	raiva
excentricidade	surpresa
desfortúnio	tristeza
lampejo	alegria
cócegas	antecipação
enrijecimento	confiança
fraco	medo
pieira	nojo
tirania	raiva
extravagância	surpresa
desgraceira	tristeza
sopro	alegria
hum	antecipação
retesamento	confiança
inclinação	medo
rouquidão	nojo
vaga	raiva
originalidade	surpresa
desastre	tristeza
transe	alegria
irresignação	antecipação
moral	confiança
queda	medo
sufoco	nojo
cacho	raiva
singularidade	surpresa
acidente	tristeza
transporte	alegria
emergência	antecipação
substância	confiança
vício	medo
termo	nojo
ondulação	raiva
espécie	surpresa
maldição	tristeza
graça	alegria
premência	antecipação
fortidão	confiança
deficiência	medo
indisposição	nojo
sinuosidade	raiva
depreciação	surpresa
penúria	tristeza
gracejo	alegria
iminência	antecipação
efetividade	confiança
deformidade	medo
incômodo	nojo
ziguezague	raiva
desamor	surpresa
indigência	tristeza
brincadeira	alegria
exigência	antecipação
seriedade	confiança
desdouro	medo
náuseas	nojo
afluência	raiva
descaso	surpresa
pobreza	tristeza
sabor	alegria
mister	antecipação
realidade	confiança
deslustre	medo
achaque	nojo
afluxo	raiva
desconsideração	surpresa
inópia	tristeza
humor	alegria
carência	antecipação
inalterabilidade	confiança
eiva	medo
enfermidade	nojo
excesso	raiva
desdém	surpresa
paupérie	tristeza
indulto	alegria
rapidez	antecipação
fundamentação	confiança
falta	medo
doença	nojo
exuberância	raiva
esquivamento	surpresa
desfavor	tristeza
indulgência	alegria
presteza	antecipação
fundamento	confiança
imperfeição	medo
treco	nojo
fartura	raiva
esquivez	surpresa
desvalimento	tristeza
perdão	alegria
prontidão	antecipação
base	confiança
ineficácia	medo
moléstia	nojo
jorro	raiva
esquiveza	surpresa
desonra	tristeza
absolvição	alegria
celeridade	antecipação
fixidade	confiança
ineficiência	medo
mazela	nojo
riqueza	raiva
menoscabo	surpresa
vergonha	tristeza
vênia	alegria
brevidade	antecipação
sono	confiança
inutilidade	medo
disforia	nojo
torrente	raiva
menosprezo	surpresa
troço	tristeza
clemência	alegria
velocidade	antecipação
sangue-frio	confiança
labéu	medo
andaço	nojo
barato	raiva
anarquia	surpresa
coisa	tristeza
contrição	alegria
agilidade	antecipação
omissão	confiança
mácula	medo
vexame	nojo
curtição	raiva
cambulhada	surpresa
porcaria	tristeza
arrependimento	alegria
fugacidade	antecipação
acinesia	confiança
mancha	medo
acanhamento	nojo
fingimento	raiva
desalinho	surpresa
joça	tristeza
lamentação	alegria
aceleramento	antecipação
paralesia	confiança
senão	medo
suplício	nojo
dissimulação	raiva
desarranjo	surpresa
destino	tristeza
justificação	alegria
incidente	antecipação
abandono	confiança
indefensabilidade	medo
tortura	nojo
falsidade	raiva
desarrumação	surpresa
fado	tristeza
pretexto	alegria
contingência	antecipação
paralisação	confiança
vulnerabilidade	medo
pudor	nojo
artifício	raiva
desorganização	surpresa
fatalismo	tristeza
evasiva	alegria
gravidade	antecipação
paralisia	confiança
desapreço	medo
fealdade	nojo
artimanha	raiva
pandemônio	surpresa
sinistro	tristeza
rodeios	alegria
crise	antecipação
estupor	confiança
vilipêndio	medo
relutância	nojo
enganação	raiva
baderna	surpresa
raio	tristeza
subterfúgio	alegria
aforçuramento	antecipação
repouso	confiança
detração	medo
queixa	nojo
engodo	raiva
barafunda	surpresa
estrela	tristeza
escusação	alegria
atarefamento	antecipação
estacionamento	confiança
pouco-caso	medo
repreensão	nojo
estratagema	raiva
baralhada	surpresa
sina	tristeza
rodeio	alegria
obstáculo	antecipação
estagnação	confiança
desrespeito	medo
censura	nojo
ostentação	raiva
caos	surpresa
má sorte	tristeza
evasão	alegria
barulho	antecipação
mesmice	confiança
desacato	medo
admoestação	nojo
complicação	raiva
meada	surpresa
descalabro	tristeza
escapatória	alegria
canudo	antecipação
aprumo	confiança
desculto	medo
reprimenda	nojo
embrulhada	raiva
mexida	surpresa
desfortuna	tristeza
tergiversação	alegria
complexo	antecipação
verticalidade	confiança
desprendimento	medo
contrário	nojo
rebuliço	raiva
miscelânea	surpresa
problema	tristeza
dispensa	alegria
história	antecipação
acordo	confiança
desapego	medo
adversário	nojo
poder	raiva
mistifório	surpresa
antropofobia	tristeza
isenção	alegria
equívoco	antecipação
equiparação	confiança
alheamento	medo
desafeiçoado	nojo
deformação	raiva
mistura	surpresa
insociabilidade	tristeza
licença	alegria
questão	antecipação
igualdade	confiança
renúncia	medo
inimigo	nojo
transformação	raiva
misturada	surpresa
introversão	tristeza
desobrigação	alegria
barreira	antecipação
paridade	confiança
abnegação	medo
intrigado	nojo
modificação	raiva
mixórdia	surpresa
isolamento	tristeza
liberação	alegria
caroço	antecipação
proporção	confiança
balbúrdia	medo
descontente	nojo
mudança	raiva
salada	surpresa
afastamento	tristeza
argumento	alegria
distúrbio	antecipação
proporcionalidade	confiança
brado	medo
embirra	nojo
mutação	raiva
trapalhada	surpresa
reclusão	tristeza
apologia	alegria
gafe	antecipação
comedimento	confiança
rebate	medo
teima	nojo
variação	raiva
ambiguidade	surpresa
retraimento	tristeza
alegação	alegria
quebra-cabeça	antecipação
autocontrole	confiança
celeuma	medo
reincidência	nojo
adulteração	raiva
desorientação	surpresa
abortamento	tristeza
autoridade	alegria
torniquete	antecipação
autodomínio	confiança
repique	medo
rivalidade	nojo
falsificação	raiva
engano	surpresa
desmancho	tristeza
causa	alegria
quebra-cabeças	antecipação
discrição	confiança
austeridade	medo
provocação	nojo
contrafação	raiva
erro	surpresa
amblose	tristeza
motivação	alegria
imbróglio	antecipação
meio-termo	confiança
incomplacência	medo
combate	nojo
corrupção	raiva
imprecisão	surpresa
móvito	tristeza
porquê	alegria
labuta	antecipação
senso	confiança
intransigência	medo
guerra	nojo
apodrecimento	raiva
obscuridade	surpresa
fiasco	tristeza
título	alegria
lida	antecipação
estadia	confiança
inclemência	medo
altercação	nojo
decomposição	raiva
zoada	surpresa
anormalidade	tristeza
móbil	alegria
trabalho	antecipação
estada	confiança
incompreensão	medo
batalha	nojo
degeneração	raiva
algazarra	surpresa
aberração	tristeza
móvel	alegria
dança	antecipação
estância	confiança
inflexibilidade	medo
contenda	nojo
degradação	raiva
arruaça	surpresa
anomalia	tristeza
alvo	alegria
turbilhão	antecipação
ficada	confiança
sectarismo	medo
disputa	nojo
deterioração	raiva
assuada	surpresa
desvio	tristeza
desígnio	alegria
tráfego	antecipação
demora	confiança
severidade	medo
desarmonia	nojo
motim	raiva
babel	surpresa
monstrengo	tristeza
escopo	alegria
diapasão	antecipação
delonga	confiança
perseguição	medo
desinteligência	nojo
subversão	raiva
bafafá	surpresa
inadequadamente	tristeza
fim	alegria
dobadoura	antecipação
pousada	confiança
crueza	medo
divisão	nojo
arranca-rabo	raiva
barulheira	surpresa
ilegalmente	tristeza
finalidade	alegria
faina	antecipação
pouso	confiança
impiedade	medo
separação	nojo
banzé	raiva
bulha	surpresa
desarmoniosamente	tristeza
intenção	alegria
maratona	antecipação
retenção	confiança
truculência	medo
primazia	nojo
bate-boca	raiva
chinfrim	surpresa
erradamente	tristeza
intento	alegria
polvorosa	antecipação
prosseguimento	confiança
maldade	medo
cizânia	nojo
rolo	raiva
discórdia	surpresa
defeituosamente	tristeza
intuito	alegria
trabalheira	antecipação
conservação	confiança
malignidade	medo
dissensão	nojo
chatice	raiva
enfrentamento	surpresa
incorretamente	tristeza
meta	alegria
triga	antecipação
continuação	confiança
malvadeza	medo
dissenso	nojo
maçada	raiva
gritaria	surpresa
irregularmente	tristeza
objetivo	alegria
trabalhão	antecipação
existência	confiança
perversidade	medo
tenção	nojo
estopada	raiva
pancadaria	surpresa
de leve	tristeza
propósito	alegria
freima	antecipação
prolongação	confiança
improbidade	medo
desamizade	nojo
lassidão	raiva
pega	surpresa
deficientemente	tristeza
estímulo	alegria
fula	antecipação
prolongamento	confiança
barbárie	medo
execrar	nojo
doidice	raiva
quebra-pau	surpresa
imperfeitamente	tristeza
incentivo	alegria
afogo	antecipação
subsequência	confiança
barbaria	medo
abominar	nojo
insanidade	raiva
quiproquó	surpresa
incompletamente	tristeza
mola	alegria
aguça	antecipação
pertinácia	confiança
barbarismo	medo
aborrecer	nojo
desvario	raiva
vozearia	surpresa
insatisfatoriamente	tristeza
impulsor	alegria
lufa	antecipação
definição	confiança
ruindade	medo
detestar	nojo
demência	raiva
inibição	surpresa
insuficientemente	tristeza
motor	alegria
lufa-lufa	antecipação
limitação	confiança
inumanidade	medo
embirrar	nojo
desatino	raiva
pejo	surpresa
pouco	tristeza
movente	alegria
amargura	antecipação
demarcação	confiança
irredutibilidade	medo
odiar	nojo
alienação	raiva
zaragata	surpresa
rapidamente	tristeza
propulsor	alegria
martírio	antecipação
delimitação	confiança
acerbidade	medo
descomedimento	nojo
insânia	raiva
escarcéu	surpresa
a custo	tristeza
causador	alegria
atormentação	antecipação
denodo	confiança
insensibilidade	medo
exagero	nojo
excepcionalidade	raiva
rumor	surpresa
apenas	tristeza
determinador	alegria
colapso	antecipação
mandado	confiança
aleijão	medo
imoderação	nojo
idolatria	raiva
ruído	surpresa
com dificuldade	tristeza
determinante	alegria
involução	antecipação
despacho	confiança
cacogênese	medo
agravo	nojo
paranoia	raiva
zoeira	surpresa
desfavoravelmente	tristeza
motivador	alegria
perecimento	antecipação
lei	confiança
enormidade	medo
arrogância	nojo
psicose	raiva
espalhafato	surpresa
dificilmente	tristeza
originador	alegria
derrocada	antecipação
decreto	confiança
teratismo	medo
atrevimento	nojo
ciúme	raiva
deus nos acuda	surpresa
dificultosamente	tristeza
provocador	alegria
descensão	antecipação
sentença	confiança
disparate	medo
cinismo	nojo
destempero	raiva
ebulição	surpresa
negativamente	tristeza
assunto	alegria
insegurança	antecipação
ordem	confiança
absurdo	medo
desaforo	nojo
alor	raiva
conturbação	surpresa
penosamente	tristeza
tema	alegria
desembaraço	antecipação
prescrição	confiança
heresia	medo
desavergonhamento	nojo
lance	raiva
rebelião	surpresa
barbaramente	tristeza
por esse motivo	alegria
impavidez	antecipação
regulamento	confiança
contrassenso	medo
descaramento	nojo
pulsão	raiva
insurreição	surpresa
bruscamente	tristeza
inteligência	alegria
afoitamente	antecipação
caracterização	confiança
sevícia	medo
desfaçatez	nojo
rasgo	raiva
insubordinação	surpresa
cruelmente	tristeza
intelecto	alegria
afoitamento	antecipação
especificação	confiança
canibalismo	medo
desplante	nojo
encorajamento	raiva
amotinação	surpresa
desumanamente	tristeza
raciocínio	alegria
destemor	antecipação
contagem	confiança
animal	medo
injúria	nojo
incitamento	raiva
sublevação	surpresa
duramente	tristeza
intelecção	alegria
heroísmo	antecipação
resposta	confiança
sangue	medo
insolência	nojo
instigação	raiva
sedição	surpresa
grosseiramente	tristeza
intelectualidade	alegria
clareza	antecipação
solução	confiança
indignidade	medo
petulância	nojo
empurrão	raiva
levantamento	surpresa
impropriamente	tristeza
sapiência	alegria
compreensibilidade	antecipação
expediente	confiança
malícia	medo
sem-vergonhice	nojo
impulsão	raiva
alvoroto	surpresa
inconvenientemente	tristeza
mente	alegria
incomplexidade	antecipação
desenvoltura	confiança
pecado	medo
sem-vergonhismo	nojo
impulsionamento	raiva
cio	surpresa
indevidamente	tristeza
cabeça	alegria
simplicidade	antecipação
declaração	confiança
inconsciência	medo
ultraje	nojo
pulso	raiva
alma	surpresa
injustamente	tristeza
gênio	alegria
destreza	antecipação
conversão	confiança
iniquidade	medo
arbitrariedade	nojo
batimento	raiva
suspensão	surpresa
rudemente	tristeza
capacidade	alegria
aptidão	antecipação
metamorfose	confiança
maus-tratos	medo
despotismo	nojo
arrancada	raiva
embriaguez	surpresa
severamente	tristeza
mentalidade	alegria
dom	antecipação
acuidade	confiança
animalidade	medo
prepotência	nojo
efusão	raiva
fissura	surpresa
jamais	tristeza
esperteza	alegria
jeito	antecipação
nitidez	confiança
estupidez	medo
defloramento	nojo
embalo	raiva
súbito	surpresa
não	tristeza
sagacidade	alegria
perícia	antecipação
qualidade	confiança
transgressão	medo
desfloração	nojo
vitalidade	raiva
abrasamento	surpresa
nunca	tristeza
perspicácia	alegria
predisposição	antecipação
fluxo	confiança
infração	medo
estupro	nojo
tempestade	raiva
anagogia	surpresa
assim que	tristeza
argúcia	alegria
propensão	antecipação
relaxação	confiança
violação	medo
superstição	nojo
temporal	raiva
espasmo	surpresa
logo que	tristeza
agudeza	alegria
talento	antecipação
relaxamento	confiança
delito	medo
crendice	nojo
vendaval	raiva
gama	surpresa
dano	tristeza
discernimento	alegria
aberta	antecipação
soltura	confiança
tropeço	medo
abusão	nojo
rajada	raiva
incandescência	surpresa
adoecimento	tristeza
bom senso	alegria
ansa	antecipação
parecer	confiança
deslize	medo
estuo	nojo
chuva	raiva
instinto	surpresa
morbo	tristeza
ponderação	alegria
azo	antecipação
veredito	confiança
criminalidade	medo
conflagração	nojo
procela	raiva
rapto	surpresa
desvantagem	tristeza
critério	alegria
brecha	antecipação
julgamento	confiança
delinquência	medo
levante	nojo
glorificação	raiva
surto	surpresa
inconveniência	tristeza
sensatez	alegria
chance	antecipação
arbítrio	confiança
incoerência	medo
revolucionamento	nojo
louvor	raiva
voo	surpresa
malefício	tristeza
lucidez	alegria
ensejo	antecipação
escolha	confiança
despautério	medo
revolvimento	nojo
encômio	raiva
impressão	surpresa
malfeito	tristeza
tino	alegria
entrada	antecipação
final	confiança
despropósito	medo
inovação	nojo
engrandecimento	raiva
noção	surpresa
nocividade	tristeza
circunspecção	alegria
hora	antecipação
finalíssima	confiança
ilogismo	medo
novidade	nojo
elogio	raiva
sensibilidade	surpresa
perniciosidade	tristeza
cordura	alegria
instante	antecipação
fortificação	confiança
irracionalidade	medo
reforma	nojo
consagração	raiva
escurecimento	surpresa
mal-entendido	tristeza
origem	alegria
lace	antecipação
forte	confiança
feioso	medo
renovação	nojo
distinção	raiva
encadeamento	surpresa
foi mal	tristeza
fonte	alegria
momento	antecipação
castelo	confiança
criatura	medo
giro	nojo
enaltecimento	raiva
esplendor	surpresa
impedimento	tristeza
argumentação	alegria
ocasião	antecipação
cidadela	confiança
ogro	medo
rotação	nojo
afervoramento	raiva
fulgência	surpresa
inversão	tristeza
premissa	alegria
oportunidade	antecipação
baluarte	confiança
besta	medo
jeriza	nojo
excitamento	raiva
magnificiência	surpresa
óbice	tristeza
informação	alegria
possibilidade	antecipação
praça	confiança
desumano	medo
aviltamento	nojo
tentação	raiva
magia	surpresa
percalço	tristeza
notícia	alegria
vez	antecipação
bastião	confiança
cruel	medo
descrédito	nojo
libido	raiva
bruxaria	surpresa
apocalipse	tristeza
nova	alegria
faculdades	antecipação
alcácer	confiança
malvado	medo
desfeita	nojo
lubricidade	raiva
mágica	surpresa
hecatombe	tristeza
porcentagem	alegria
meios	antecipação
munição	confiança
desalmado	medo
doesto	nojo
lascívia	raiva
ímã	surpresa
armagedom	tristeza
percentagem	alegria
recursos	antecipação
potência	confiança
perverso	medo
ignomínia	nojo
incitação	raiva
magnetismo	surpresa
devastação	tristeza
relação	alegria
valências	antecipação
pujança	confiança
bárbaro	medo
infâmia	nojo
acoroçoamento	raiva
talismã	surpresa
destruição	tristeza
comparação	alegria
condescendência	antecipação
fibra	confiança
atroz	medo
insulto	nojo
fomentação	raiva
condão	surpresa
epidemia	tristeza
justiça	alegria
tolerância	antecipação
longanimidade	confiança
diabólico	medo
opróbrio	nojo
fustigação	raiva
prestígio	surpresa
açoite	tristeza
imparcialidade	alegria
pique	antecipação
virtude	confiança
fera	medo
pirraça	nojo
assanho	raiva
atrativo	surpresa
reviravolta	tristeza
equidade	alegria
fogo	antecipação
fleuma	confiança
carrasco	medo
vitupério	nojo
condenação	raiva
sortilégio	surpresa
cano	tristeza
direito	alegria
febre	antecipação
desídia	confiança
celerado	medo
vergonheira	nojo
hidrofobia	raiva
sonho	surpresa
reverso	tristeza
em razão de	alegria
roda-viva	antecipação
filosofia	confiança
enorme	medo
vexação	nojo
perdição	raiva
bruxedo	surpresa
avesso	tristeza
em razão	alegria
bulício	antecipação
peito	confiança
gigante	medo
dispneia	nojo
teimosia	raiva
feitiçaria	surpresa
verso	tristeza
elucidação	alegria
burburinho	antecipação
hombridade	confiança
gigantesco	medo
estafa	nojo
grito	raiva
macumba	surpresa
invés	tristeza
aclaramento	alegria
fervedouro	antecipação
nobreza	confiança
colossal	medo
exaustão	nojo
berro	raiva
mandinga	surpresa
dorso	tristeza
aclaração	alegria
abano	antecipação
grandeza	confiança
descomunal	medo
falta de ar	nojo
reclamação	raiva
necromancia	surpresa
revezamento	tristeza
esclarecimento	alegria
abanamento	antecipação
dignidade	confiança
desmedido	medo
moedeira	nojo
protesto	raiva
nigromancia	surpresa
tensão	tristeza
explanação	alegria
abanadura	antecipação
branqueação	confiança
alimária	medo
assalto	nojo
lanço	raiva
poção	surpresa
desesperação	tristeza
interpretação	alegria
agitamento	antecipação
alvejamento	confiança
animalejo	medo
invectiva	nojo
improvisação	raiva
beleza	surpresa
contristação	tristeza
aula	alegria
manifestação	antecipação
branqueamento	confiança
animália	medo
investida	nojo
improviso	raiva
formosura	surpresa
pesadelo	tristeza
aula particular	alegria
comício	antecipação
cora	confiança
asno	medo
afrontação	nojo
rasteiro	raiva
arroubamento	surpresa
apertura	tristeza
ensino	alegria
atilamento	antecipação
coradouro	confiança
bichano	medo
afrontamento	nojo
rastejante	raiva
enlevação	surpresa
espinho	tristeza
lecionação	alegria
asseio	antecipação
franqueza	confiança
bicho-de-pé	medo
confronto	nojo
reptante	raiva
acatamento	surpresa
inferno	tristeza
lição	alegria
alinho	antecipação
resultado	confiança
burro	medo
bagagem	nojo
sextilha	raiva
atendimento	surpresa
trato	tristeza
desafronta	alegria
afinação	antecipação
arbitramento	confiança
cupim	medo
carga	nojo
de repente	raiva
cumprimento	surpresa
penitência	tristeza
contrapartida	alegria
elegância	antecipação
análise	confiança
inseto	medo
carregamento	nojo
orgulho	raiva
observação	surpresa
véu	tristeza
contrapeso	alegria
exatidão	antecipação
debate	confiança
piolho	medo
carrego	nojo
altivez	raiva
submissão	surpresa
perigo	tristeza
equivalência	alegria
galhardia	antecipação
exame	confiança
térmite	medo
fardo	nojo
arrogante	raiva
subordinação	surpresa
atenazamento	tristeza
correspondência	alegria
garbo	antecipação
questionamento	confiança
traça	medo
frete	nojo
orgulhoso	raiva
referência	surpresa
dolência	tristeza
agradecimento	alegria
refinação	antecipação
reflexão	confiança
verme	medo
volume	nojo
altivo	raiva
aspecto	surpresa
flagelação	tristeza
preço	alegria
refinamento	antecipação
justeza	confiança
bruto	medo
ascendência	nojo
rompente	raiva
perspectiva	surpresa
provação	tristeza
torna	alegria
requinte	antecipação
retidão	confiança
cavalo	medo
importância	nojo
aferro	raiva
ângulo	surpresa
calvário	tristeza
troca	alegria
sublimidade	antecipação
acribia	confiança
estúpido	medo
influência	nojo
intensão	raiva
lado	surpresa
cilício	tristeza
benefício	alegria
atoleiro	antecipação
acribologia	confiança
grosso	medo
mérito	nojo
eloquência	raiva
modo	surpresa
cruz	tristeza
lucro	alegria
embrulho	antecipação
concisão	confiança
mal-educado	medo
culpa	nojo
oratória	raiva
ponto de vista	surpresa
espinha	tristeza
ganho	alegria
enrascada	antecipação
laconismo	confiança
corajoso	medo
remorso	nojo
loquacidade	raiva
prisma	surpresa
sobrecarga	tristeza
em compensação	alegria
entalação	antecipação
sintetismo	confiança
decidido	medo
dever	nojo
magniloquência	raiva
homenagens	surpresa
traspasso	tristeza
retorno	alegria
entaladela	antecipação
regularidade	confiança
desassombrado	medo
encargo	nojo
altiloquência	raiva
recomendações	surpresa
penar	tristeza
reposição	alegria
impasse	antecipação
exação	confiança
amigo	medo
incumbência	nojo
facundidade	raiva
saudações	surpresa
resignação	tristeza
entrega	alegria
sinuca	antecipação
privação	confiança
camarada	medo
obrigação	nojo
facúndia	raiva
a respeito de	surpresa
conformação	tristeza
recondução	alegria
apurado	antecipação
indispensabilidade	confiança
cara	medo
ônus	nojo
ganância	raiva
a respeito	surpresa
conformidade	tristeza
reversão	alegria
purificação	antecipação
ação	confiança
chapa	medo
responsabilidade	nojo
cobiça	raiva
no que diz respeito	surpresa
mesquinharia	tristeza
recuperação	alegria
ápice	antecipação
eficácia	confiança
fulano	medo
halter	nojo
cupidez	raiva
diz respeito	surpresa
vileza	tristeza
estipêndio	alegria
corre-corre	antecipação
eficiência	confiança
ás	medo
haltere	nojo
esganação	raiva
dizer respeito a	surpresa
sordidez	tristeza
honorário	alegria
acabamento	antecipação
alento	confiança
bom	medo
tonteira	nojo
intemperança	raiva
no que diz respeito a	surpresa
insignificância	tristeza
ordenado	alegria
aprimoramento	antecipação
viço	confiança
especialista	medo
delíquio	nojo
destemperança	raiva
conta	surpresa
pequenez	tristeza
salário	alegria
arremate	antecipação
afincamento	confiança
exímio	medo
vertigem	nojo
gula	raiva
valimento	surpresa
avareza	tristeza
mercê	alegria
remate	antecipação
contumácia	confiança
experto	medo
zonzeira	nojo
glutonaria	raiva
apreciação	surpresa
sovinice	tristeza
jornal	alegria
retoque	antecipação
insistência obduração	confiança
perito	medo
arrufo	nojo
alarvaria	raiva
meditação	surpresa
escassez	tristeza
jorna	alegria
bebedeira	antecipação
perenidade	confiança
bonificação	medo
vácuo	nojo
edacidade	raiva
alegações	surpresa
vilania	tristeza
vencimento	alegria
garotice	antecipação
vigência	confiança
aprendiz	medo
enfadamento	nojo
ereção	raiva
argumentos	surpresa
agarramento	tristeza
rendimento	alegria
infantilidade	antecipação
frequência	confiança
calouro	medo
seca	nojo
concupiscência	raiva
arrazoados	surpresa
estreiteza	tristeza
féria	alegria
meninice	antecipação
periodicidade	confiança
estudante	medo
reação	nojo
tesura	raiva
considerandos	surpresa
miudeza	tristeza
pago	alegria
candura	antecipação
apego	confiança
iniciante	medo
rechaço	nojo
esticamento	raiva
ideias	surpresa
poupança	tristeza
provento	alegria
ingenuidade	antecipação
lealdade	confiança
novato	medo
renitência	nojo
estiramento	raiva
motivos	surpresa
somiticaria	tristeza
recebimento	alegria
inocência	antecipação
fidelidade	confiança
primeiranista	medo
bloqueio	nojo
imaginação	raiva
razões	surpresa
pão-durismo	tristeza
explica	alegria
pureza	antecipação
acinte	confiança
principiante	medo
empecilho	nojo
veio	raiva
reflexões	surpresa
tacanhice	tristeza
desempenha	alegria
meninada	antecipação
caturrice	confiança
bicho do mato	medo
desaceitação	nojo
pluma	raiva
tendo em consideração	surpresa
trabuzana	tristeza
contribui	alegria
petizada	antecipação
obumbração	confiança
insociável	medo
resistor	nojo
penacho	raiva
culto	surpresa
alagamento	tristeza
corresponde	alegria
gurizada	antecipação
batalhação	confiança
misantropo	medo
atrito	nojo
penalidade	raiva
homenagem	surpresa
inundação	tristeza
diária	alegria
pequenada	antecipação
desdobramento	confiança
solitário	medo
fricção	nojo
multa	raiva
cegueira	surpresa
nevasca	tristeza
embolso	alegria
infância	antecipação
rebeldia	confiança
bicho-de-galinha	medo
defensão	nojo
corretivo	raiva
honra	surpresa
tufão	tristeza
emolumento	alegria
garotada	antecipação
revelia	confiança
belzebu	medo
contradição	nojo
coima	raiva
preito	surpresa
emenda	tristeza
honorários	alegria
molecada	antecipação
utilização	confiança
anjo mau	medo
contraposição	nojo
condolência	raiva
altar	surpresa
exemplo	tristeza
soldada	alegria
pirralhada	antecipação
execução	confiança
tinhoso	medo
contradita	nojo
cálamo	raiva
afeto	surpresa
escarmento	tristeza
soldo	alegria
crianças	antecipação
prática	confiança
lúcifer	medo
desmentido	nojo
escrita	raiva
querer	surpresa
vindita	tristeza
comissão	alegria
desmazelo	antecipação
aplicabilidade	confiança
canhoto	medo
desigualdade	nojo
estilo	raiva
chamego	surpresa
látego	tristeza
abono	alegria
desleixo	antecipação
realização	confiança
cão	medo
disparidade	nojo
escritor	raiva
latria	surpresa
bronca	tristeza
cota	alegria
imprecaução	antecipação
observância	confiança
chifrudo	medo
discrepância	nojo
autor	raiva
bem-querer	surpresa
chamada	tristeza
parcela	alegria
imprevidência	antecipação
utilidade	confiança
cornudo	medo
dissemelhança	nojo
ter pena de	raiva
querença	surpresa
ensinadela	tristeza
prestação	alegria
imprevisão	antecipação
uso	confiança
demônio	medo
contraste	nojo
sacrifício	raiva
benquerença	surpresa
sermão	tristeza
quota	alegria
improvidência	antecipação
emprego	confiança
mafarrico	medo
assimetria	nojo
desforra	raiva
dileção	surpresa
carraspana	tristeza
recompensação	alegria
indolência	antecipação
serventia	confiança
maldito	medo
antinomia	nojo
retaliação	raiva
carinho	surpresa
descompostura	tristeza
purgação	alegria
desacerto	antecipação
efeito	confiança
maligno	medo
desacordo	nojo
revanche	raiva
ternura	surpresa
sabão	tristeza
despique	alegria
escorregadela	antecipação
função	confiança
satã	medo
discordância	nojo
represália	raiva
amizade	surpresa
sarabanda	tristeza
forra	alegria
lapso	antecipação
funcionalidade	confiança
satanás	medo
incongruência	nojo
revide	raiva
meiguice	surpresa
cautério	tristeza
restauração	alegria
cochilo	antecipação
concentração	confiança
serpente	medo
contraditória	nojo
troco	raiva
ligação	surpresa
importunação	tristeza
reabilitação	alegria
mobilidade	antecipação
administração	confiança
tendeiro	medo
réplica	nojo
saldo	raiva
tendência	surpresa
espalhanço	tristeza
repetição	alegria
motilidade	antecipação
ministração	confiança
tentador	medo
atravanco	nojo
desforço	raiva
pendor	surpresa
surra	tristeza
reintegração	alegria
moto	antecipação
investimento	confiança
agitado	medo
empeço	nojo
desequilíbrio	raiva
vocação	surpresa
sova	tristeza
estorno	alegria
cinesia	antecipação
adorno	confiança
diabrete	medo
encalhe	nojo
desgoverno	raiva
habilidade	surpresa
espancamento	tristeza
espórtula	alegria
deslocação	antecipação
enfeite	confiança
irrequieto	medo
inconveniente	nojo
desregramento	raiva
veia	surpresa
pau	tristeza
molhadura	alegria
deslocamento	antecipação
adereço	confiança
levado	medo
obstrução	nojo
agravamento	raiva
dilecção	surpresa
bordoada	tristeza
subsídio	alegria
locomoção	antecipação
ornamento	confiança
traquina	medo
pespego	nojo
brabeza	raiva
merecimento	surpresa
esfrega	tristeza
alvíssaras	alegria
curso	antecipação
guarnição	confiança
travesso	medo
tranca	nojo
bravosidade	raiva
valia	surpresa
trepa	tristeza
redenção	alegria
passagem	antecipação
ornato	confiança
arguto	medo
travanca	nojo
chicote	raiva
recolhimento	surpresa
tosa	tristeza
relevação	alegria
transferência	antecipação
colocação	confiança
astucioso	medo
motinação	nojo
azorrague	raiva
asceticismo	surpresa
tosquiadela	tristeza
relevamento	alegria
dinâmica	antecipação
sobreposição	confiança
astuto	medo
alarido	nojo
vergalho	raiva
ascetismo	surpresa
tareia	tristeza
Catarse	alegria
concorrência	antecipação
superposição	confiança
esperto	medo
desobediência	nojo
vergasta	raiva
beatitude	surpresa
escovadela	tristeza
jubileu	alegria
circulação	antecipação
justaposição	confiança
inteligente	medo
insubmissão	nojo
peste	raiva
mística	surpresa
malha	tristeza
reparo	alegria
trânsito	antecipação
aposição	confiança
perspicaz	medo
agrura	nojo
relho	raiva
misticismo	surpresa
malhação	tristeza
conserto	alegria
meneio	antecipação
cominação	confiança
sagaz	medo
custo	nojo
pandemia	raiva
benevolência	surpresa
regresso	tristeza
arranjo	alegria
rebolado	antecipação
inflição	confiança
bodega	medo
suor	nojo
maldoso	raiva
contemporização	surpresa
retornamento	tristeza
restauro	alegria
bamboleio	antecipação
aplicativo	confiança
diacho	medo
complexidade	nojo
maléfico	raiva
subserviência	surpresa
retornança	tristeza
remendo	alegria
requebro	antecipação
programa	confiança
caramba	medo
complexidão	nojo
malévolo	raiva
sujeição	surpresa
revinda	tristeza
ajuste	alegria
requebrado	antecipação
bel-prazer	confiança
cáspite	medo
enredamento	nojo
vil	raiva
humildade	surpresa
tornada	tristeza
obra	alegria
remelexo	antecipação
alvitre	confiança
estafermo	medo
obscenidade	nojo
insensível	raiva
aferição	surpresa
vinda	tristeza
abjuração	alegria
meneamento	antecipação
alvedrio	confiança
garganta	medo
indecência	nojo
impiedoso	raiva
aproximação	surpresa
circunferência	tristeza
apostasia	alegria
gesto	antecipação
talante	confiança
cânion	medo
desonestidade	nojo
inclemente	raiva
afinidade	surpresa
borda	tristeza
recuo	alegria
aceno	antecipação
líbito	confiança
peça	medo
desvergonha	nojo
duro	raiva
confraternidade	surpresa
circuito	tristeza
céu	alegria
gesticulação	antecipação
mando	confiança
bofe	medo
imoralidade	nojo
feroz	raiva
empatia	surpresa
círculo	tristeza
paraíso	alegria
trejeito	antecipação
moto-próprio	confiança
centopeia	medo
abjeção	nojo
odioso	raiva
fraternidade	surpresa
contorno	tristeza
boa sorte	alegria
grupo	antecipação
nução	confiança
dragão	medo
turpitude	nojo
malevolente	raiva
identidade	surpresa
pirueta	tristeza
risco	alegria
partido	antecipação
opção	confiança
morteiro	medo
desacolhimento	nojo
molesto	raiva
solidariedade	surpresa
redor	tristeza
bafejo	alegria
organização	antecipação
volição	confiança
benzedeira	medo
negativa	nojo
pravo	raiva
pessoa agradável	surpresa
roda	tristeza
futuro	alegria
agrupamento	antecipação
aspiração	confiança
necromante	medo
fora	nojo
defeituoso	raiva
ritual	surpresa
rodada	tristeza
fadário	alegria
associação	antecipação
capricheira	confiança
adivinha	medo
abstenção	nojo
mal-acabado	raiva
sombração	surpresa
rodopio	tristeza
sestro	alegria
agremiação	antecipação
veneta	confiança
feiticeira	medo
reprovação	nojo
ruim	raiva
espectro	surpresa
translação	tristeza
mera	alegria
sociedade	antecipação
à vontade	confiança
maga	medo
desaprovação	nojo
imperfeito	raiva
duende	surpresa
passeio	tristeza
cadeia	alegria
liga	antecipação
boa vontade	confiança
nigromante	medo
desabono	nojo
desprimoroso	raiva
espetro	surpresa
girata	tristeza
presídio	alegria
união	antecipação
cravação	confiança
vidente	medo
veto	nojo
inferior	raiva
visagem	surpresa
virada	tristeza
penitenciária	alegria
mobilização	antecipação
cravamento	confiança
megera	medo
repudiação	nojo
medíocre	raiva
espírito	surpresa
viradela	tristeza
xilindró	alegria
corrente	antecipação
pregagem	confiança
seresma	medo
evitação	nojo
ordinário	raiva
fantasia	surpresa
viragem	tristeza
cárcere	alegria
andamento	antecipação
índole	confiança
borboleta	medo
preterição	nojo
péssimo	raiva
sombra	surpresa
espira	tristeza
xadrez	alegria
tempo	antecipação
temperamento	confiança
mariposa	medo
ostracismo	nojo
reles	raiva
anhangá	surpresa
espiral	tristeza
referida	alegria
marcha	antecipação
feição	confiança
panapaná	medo
desamparo	nojo
irregular	raiva
coco	surpresa
rosca	tristeza
expressa	alegria
sandice	antecipação
presença	confiança
bolsa	medo
desabrigo	nojo
velho	raiva
marmota	surpresa
volteio	tristeza
exposta	alegria
senilidade	antecipação
aparência	confiança
mala	medo
desarrimo	nojo
estragado	raiva
vista	surpresa
curva	tristeza
manda	alegria
tolice	antecipação
contextura	confiança
saco	medo
cena	nojo
horrível	raiva
olhar	surpresa
meandro	tristeza
determina	alegria
tontice	antecipação
corpo	confiança
meretriz	medo
esparramo	nojo
atamancado	raiva
olho	surpresa
serpeio	tristeza
impõe	alegria
idiotice	antecipação
textura	confiança
prostituta	medo
querela	nojo
mal-amanhado	raiva
visiva	surpresa
tortuosidade	tristeza
estabelece	alegria
asneira	antecipação
compacidade	confiança
vaca	medo
estardalhaço	nojo
mal-ajambrado	raiva
ilusão	surpresa
guinada	tristeza
denominada	alegria
baboseira	antecipação
encorpamento	confiança
cantada	medo
excreção	nojo
prejudicial	raiva
cenário	surpresa
viravolta	tristeza
herança	alegria
caduquice	antecipação
compatibilidade	confiança
galanteio	medo
ejeção	nojo
desvantajoso	raiva
imagem	surpresa
volta-face	tristeza
fazenda	alegria
imbecilidade	antecipação
coerência	confiança
conversa	medo
evacuação	nojo
infeliz	raiva
paisagem	surpresa
desar	tristeza
recurso	alegria
necedade	antecipação
congruência	confiança
papo	medo
proscrição	nojo
triste	raiva
panorama	surpresa
replicação	tristeza
bens	alegria
nescidade	antecipação
lógica	confiança
lábia	medo
eliminação	nojo
trágico	raiva
revelação	surpresa
vindicta	tristeza
posses	alegria
estapafurdismo	antecipação
solicitação	confiança
patifaria	medo
exclusão	nojo
catastrófico	raiva
visom	surpresa
laçada	tristeza
acervo	alegria
exotismo	antecipação
pedido	confiança
canalhice	medo
expurgação	nojo
danoso	raiva
vison	surpresa
por volta de	tristeza
algo	alegria
intensificação	antecipação
súplica	confiança
safadeza	medo
secreção	nojo
desastroso	raiva
ficção	surpresa
lamúria	tristeza
luxo	alegria
afogadela	antecipação
rogo	confiança
sacanagem	medo
emissão	nojo
fatal	raiva
invenção	surpresa
choro	tristeza
fábula	alegria
afobamento	antecipação
suplicação	confiança
velhacaria	medo
expiração	nojo
grave	raiva
quimera	surpresa
lamento	tristeza
aventura	alegria
aluamento	antecipação
invocação	confiança
velhacagem	medo
segregação	nojo
terrível	raiva
utopia	surpresa
queixume	tristeza
meio	alegria
parvulez	antecipação
peditório	confiança
velhacada	medo
freio	nojo
funesto	raiva
abantesma	surpresa
percussão	tristeza
posse	alegria
fatuidade	antecipação
jurisdição	confiança
trapaça	medo
proibição	nojo
nefasto	raiva
avantesma	surpresa
murro	tristeza
condição	alegria
parvoíce	antecipação
foro	confiança
ninharia	medo
contenção	nojo
nocivo	raiva
avejão	surpresa
soco	tristeza
natural	alegria
estultícia	antecipação
comarca	confiança
mixaria	medo
interrupção	nojo
lesivo	raiva
fantasmagoria	surpresa
sopapo	tristeza
dinheiro	alegria
insipiência	antecipação
alçada	confiança
ridicularia	medo
represa	nojo
pernicioso	raiva
fictício	surpresa
marca	tristeza
erva	alegria
paradoxo	antecipação
competência	confiança
migalhice	medo
recalcamento	nojo
calamitoso	raiva
inventado	surpresa
contusão	tristeza
tesouro	alegria
tagarelice	antecipação
âmbito	confiança
zé-ninguém	medo
castigador	nojo
infausto	raiva
simulado	surpresa
pisadura	tristeza
haver	alegria
falação	antecipação
campo	confiança
pé-rapado	medo
punidor	nojo
infesto	raiva
irreal	surpresa
equimose	tristeza
vento	alegria
parolagem	antecipação
domínio	confiança
insignificante	medo
repressor	nojo
malfazejo	raiva
fingido	surpresa
ferida	tristeza
chorume	alegria
pretensão	antecipação
nível	confiança
joão-ninguém	medo
sentenciador	nojo
miserável	raiva
aparente	surpresa
ferimento	tristeza
independência	alegria
gabolice	antecipação
esfera	confiança
borra-botas	medo
descarte	nojo
lamentável	raiva
suposto	surpresa
hematoma	tristeza
nota	alegria
suavidade	antecipação
categoria	confiança
pobre-diabo	medo
despojo	nojo
desastrado	raiva
simulacro	surpresa
lesão	tristeza
ouro	alegria
airosidade	antecipação
setor	confiança
homúnculo	medo
refugo	nojo
ruinoso	raiva
esqueleto	surpresa
mossa	tristeza
patrimônio	alegria
sutileza	antecipação
área	confiança
calhambeque	medo
despojamento	nojo
ominoso	raiva
magrelo	surpresa
pisadela	tristeza
cacife	alegria
singeleza	antecipação
eutimia	confiança
cacareco	medo
descuramento	nojo
nocente	raiva
magricela	surpresa
trauma	tristeza
feito	alegria
frescor	antecipação
mansidão	confiança
bugiganga	medo
desproteção	nojo
indelicado	raiva
fato	surpresa
traumatismo	tristeza
conquista	alegria
lisura	antecipação
pacacidade	confiança
caco	medo
renunciação	nojo
desagradável	raiva
episódio	surpresa
talho	tristeza
troféu	alegria
finura	antecipação
pacatez	confiança
tralha	medo
distanciamento	nojo
descortês	raiva
caso	surpresa
corte	tristeza
brilharete	alegria
vaporosidade	antecipação
eupatia	confiança
tareco	medo
controvérsia	nojo
intratável	raiva
ocorrido	surpresa
incisão	tristeza
brilhantura	alegria
tenuidade	antecipação
pachorra	confiança
traste	medo
demanda	nojo
rude	raiva
sucedido	surpresa
chofre	tristeza
peripécia	alegria
transparência	antecipação
coesão	confiança
negócio	medo
litígio	nojo
ríspido	raiva
sábio	surpresa
truque	tristeza
acontecido	alegria
lepidez	antecipação
aderência	confiança
trem	medo
polêmica	nojo
áspero	raiva
erudito	surpresa
trama	tristeza
desfecho	alegria
prognosticação	antecipação
adesão	confiança
parada	medo
arrenegar	nojo
insuportável	raiva
crânio	surpresa
desfalque	tristeza
conclusão	alegria
futuração	antecipação
viscosidade	confiança
pertences	medo
indeferir	nojo
intolerável	raiva
aparecimento	surpresa
rombo	tristeza
desenlace	alegria
adivinhamento	antecipação
sovinaria	confiança
coisas	medo
negar	nojo
detestável	raiva
surgimento	surpresa
roubo	tristeza
