	0
alegria	alegria
antecipação	antecipação
confiança	confiança
medo	medo
nojo	nojo
raiva	raiva
surpresa	surpresa
tristeza	tristeza
contentamento	alegria
precipitação	antecipação
firmeza	confiança
pavor	medo
asco	nojo
fúria	raiva
espanto	surpresa
infelicidade	tristeza
satisfação	alegria
previsão	antecipação
segurança	confiança
fobia	medo
aversão	nojo
ira	raiva
admiração	surpresa
desânimo	tristeza
felicidade	alegria
profecia	antecipação
certeza	confiança
horror	medo
náusea	nojo
cólera	raiva
assombro	surpresa
tristura	tristeza
prazer	alegria
presságio	antecipação
convicção	confiança
terror	medo
enjoo	nojo
irritação	raiva
pasmo	surpresa
descontentamento	tristeza
regozijo	alegria
adiantamento	antecipação
força	confiança
pânico	medo
repugnância	nojo
ódio	raiva
maravilha	surpresa
abatimento	tristeza
júbilo	alegria
avanço	antecipação
fé	confiança
temor	medo
repulsão	nojo
gana	raiva
maravilhamento	surpresa
melancolia	tristeza
riso	alegria
abreviação	antecipação
crença	confiança
susto	medo
repulsa	nojo
furor	raiva
sobressalto	surpresa
desalento	tristeza
bom humor	alegria
prevenção	antecipação
esperança	confiança
ojeriza	medo
fastio	nojo
zanga	raiva
abalo	surpresa
desolação	tristeza
agrado	alegria
predição	antecipação
otimismo	confiança
amedrontamento	medo
abominação	nojo
agressividade	raiva
choque	surpresa
desconsolo	tristeza
regalo	alegria
prolepse	antecipação
familiaridade	confiança
receio	medo
animosidade	nojo
sanha	raiva
comoção	surpresa
insatisfação	tristeza
animação	alegria
antevisão	antecipação
informalidade	confiança
apreensão	medo
enojo	nojo
exasperação	raiva
perturbação	surpresa
esmorecimento	tristeza
gosto	alegria
imaturidade	antecipação
intimidade	confiança
preocupação	medo
engulho	nojo
frustração	raiva
emoção	surpresa
prostração	tristeza
bem-estar	alegria
anástrofe	antecipação
boa fama	confiança
ansiedade	medo
antojo	nojo
indignação	raiva
estranheza	surpresa
depressão	tristeza
comprazimento	alegria
hipérbato	antecipação
boa reputação	confiança
inquietação	medo
luto	nojo
antipatia	raiva
espavento	surpresa
desesperança	tristeza
contento	alegria
sínquise	antecipação
confiabilidade	confiança
incerteza	medo
dó	nojo
odiosidade	raiva
fascínio	surpresa
mágoa	tristeza
deleite	alegria
previsibilidade	antecipação
credibilidade	confiança
dúvida	medo
pesar	nojo
execração	raiva
imprevisto	surpresa
desgosto	tristeza
euforia	alegria
leviandade	antecipação
estabilidade	confiança
fraqueza	medo
ânsia	nojo
frenesi	raiva
estupefação	surpresa
azar	tristeza
alacridade	alegria
irreflexão	antecipação
solidez	confiança
desprezo	medo
mal-estar	nojo
impetuosidade	raiva
perplexidade	surpresa
desgraça	tristeza
aprazimento	alegria
impaciência	antecipação
fixidez	confiança
alarma	medo
repelência	nojo
repelo	raiva
estuporação	surpresa
fatalidade	tristeza
desfastio	alegria
urgência	antecipação
imobilidade	confiança
cagaço	medo
rancor	nojo
violência	raiva
estranhez	surpresa
desdita	tristeza
entusiasmo	alegria
açodamento	antecipação
equilíbrio	confiança
estarrecimento	medo
animadversão	nojo
onda	raiva
confusão	surpresa
desventura	tristeza
jovialidade	alegria
atrapalhação	antecipação
permanência	confiança
intolerância	medo
desafeto	nojo
alteração	raiva
alvoroço	surpresa
infortúnio	tristeza
jubilidade	alegria
azáfama	antecipação
determinação	confiança
crueldade	medo
embirração	nojo
aborrecimento	raiva
arrebatamento	surpresa
misantropia	tristeza
ledice	alegria
imprudência	antecipação
resolução	confiança
monstruosidade	medo
hostilidade	nojo
loucura	raiva
sensação	surpresa
aborto	tristeza
desculpa	alegria
pressa	antecipação
decisão	confiança
barbaridade	medo
inimizade	nojo
impulso	raiva
deslumbramento	surpresa
mal	tristeza
escusa	alegria
agonia	antecipação
fortaleza	confiança
atrocidade	medo
malquerença	nojo
ímpeto	raiva
deslumbre	surpresa
adversidade	tristeza
justificativa	alegria
afoiteza	antecipação
impassibilidade	confiança
hediondez	medo
malquerer	nojo
borrasca	raiva
encantamento	surpresa
calamidade	tristeza
motivo	alegria
temeridade	antecipação
coragem	confiança
selvajaria	medo
abuso	nojo
exaltação	raiva
encanto	surpresa
catástrofe	tristeza
razão	alegria
facilidade	antecipação
desassombro	confiança
desumanidade	medo
estuação	nojo
excitação	raiva
êxtase	surpresa
revés	tristeza
explicação	alegria
agitação	antecipação
deliberação	confiança
bestialidade	medo
revolução	nojo
acromania	raiva
fascinação	surpresa
tragédia	tristeza
compensação	alegria
apuro	antecipação
precisão	confiança
crime	medo
entojo	nojo
assanhamento	raiva
respeito	surpresa
aflição	tristeza
devolução	alegria
aturdimento	antecipação
energia	confiança
feiura	medo
afronta	nojo
danação	raiva
consideração	surpresa
tormento	tristeza
indenização	alegria
criancice	antecipação
persistência	confiança
monstro	medo
naupatia	nojo
embravecimento	raiva
veneração	surpresa
sofrimento	tristeza
paga	alegria
criançada	antecipação
perseverança	confiança
bicho	medo
peso	nojo
encarniçamento	raiva
adoração	surpresa
mesquinhez	tristeza
pagamento	alegria
descuido	antecipação
constância	confiança
diabo	medo
tontura	nojo
estrilo	raiva
afeição	surpresa
contratempo	tristeza
recompensa	alegria
inadvertência	antecipação
insistência	confiança
mostrengo	medo
enfado	nojo
repente	raiva
apreço	surpresa
intempérie	tristeza
reembolso	alegria
movimento	antecipação
obstinação	confiança
canhão	medo
enfaro	nojo
rompante	raiva
contemplação	surpresa
castigo	tristeza
remuneração	alegria
maluqueira	antecipação
aplicação	confiança
bruxa	medo
tédio	nojo
veemência	raiva
deferência	surpresa
volta	tristeza
ressarcimento	alegria
maluquice	antecipação
vontade	confiança
bruaca	medo
resistência	nojo
voracidade	raiva
estima	surpresa
lástima	tristeza
restituição	alegria
aceleração	antecipação
afinco	confiança
xaveco	medo
oposição	nojo
tesão	raiva
simpatia	surpresa
golpe	tristeza
retribuição	alegria
afobação	antecipação
ânimo	confiança
bagulho	medo
objeção	nojo
elã	raiva
assombração	surpresa
derrota	tristeza
desagravo	alegria
afogadilho	antecipação
assiduidade	confiança
jararaca	medo
revolta	nojo
pena	raiva
visão	surpresa
dissabor	tristeza
expiação	alegria
apressuramento	antecipação
consistência	confiança
bucho	medo
dificuldade	nojo
punição	raiva
atordoamento	surpresa
sorte	tristeza
reparação	alegria
estouvamento	antecipação
instância	confiança
desagrado	medo
torpeza	nojo
vingança	raiva
fantasma	surpresa
negrura	tristeza
retratação	alegria
insensatez	antecipação
estoicidade	confiança
desprazer	medo
rejeição	nojo
cólera-morbo	raiva
fenômeno	surpresa
negrume	tristeza
bem-aventurança	alegria
roldão	antecipação
paciência	confiança
contrariedade	medo
esquivança	nojo
mordexim	raiva
aparição	surpresa
miséria	tristeza
ventura	alegria
esparolação	antecipação
tenacidade	confiança
amofinação	medo
repúdio	nojo
descontrole	raiva
espetáculo	surpresa
sentimento	tristeza
dita	alegria
irresponsabilidade	antecipação
disciplina	confiança
dor	medo
escândalo	nojo
exacerbação	raiva
milagre	surpresa
moleza	tristeza
fortuna	alegria
leveza	antecipação
porfia	confiança
padecimento	medo
expulsão	nojo
feridade	raiva
pasmaceira	surpresa
atribulação	tristeza
sucesso	alegria
prognóstico	antecipação
robustez	confiança
dinheirão	medo
repressão	nojo
fereza	raiva
prodígio	surpresa
caiporismo	tristeza
êxito	alegria
vaticínio	antecipação
vigor	confiança
dinheirada	medo
recalque	nojo
braveza	raiva
estupefato	surpresa
casmurrice	tristeza
triunfo	alegria
prenúncio	antecipação
tenência	confiança
dinheirama	medo
asca	nojo
ferocidade	raiva
boquiaberto	surpresa
hipocondria	tristeza
vitória	alegria
prognose	antecipação
rijeza	confiança
exorbitância	medo
enjeitamento	nojo
flagelo	raiva
pasmado	surpresa
insucesso	tristeza
acerto	alegria
premonição	antecipação
rigidez	confiança
batelada	medo
entejo	nojo
mau	raiva
admirado	surpresa
macaca	tristeza
glória	alegria
presciência	antecipação
dureza	confiança
monte	medo
estranhamento	nojo
praga	raiva
espantado	surpresa
mofina	tristeza
congratulações	alegria
augúrio	antecipação
autoconfiança	confiança
montão	medo
contestação	nojo
nervosismo	raiva
estupefacto	surpresa
morrinha	tristeza
felicitações	alegria
intuição	antecipação
afirmação	confiança
quantidade	medo
denegação	nojo
neurastenia	raiva
perplexo	surpresa
suicídio	tristeza
cumprimentos	alegria
pressentimento	antecipação
autoafirmação	confiança
abundância	medo
divergência	nojo
estresse	raiva
surpreendido	surpresa
taciturnidade	tristeza
exultação	alegria
suspeita	antecipação
garantia	confiança
enxurrada	medo
impugnação	nojo
stress	raiva
surpreso	surpresa
transtorno	tristeza
gáudio	alegria
suposição	antecipação
caução	confiança
porção	medo
nega	nojo
droga	raiva
absorto	surpresa
urucubaca	tristeza
jubilação	alegria
conjectura	antecipação
fiança	confiança
profusão	medo
negaça	nojo
grosseiro	raiva
embasbacado	surpresa
vicissitude	tristeza
deleitação	alegria
hipótese	antecipação
penhor	confiança
série	medo
negação	nojo
agastamento	raiva
atônito	surpresa
zica	tristeza
deleitamento	alegria
pressuposição	antecipação
proteção	confiança
chorrilho	medo
negamento	nojo
azedume	raiva
portento	surpresa
tanglomanglo	tristeza
delícia	alegria
presunção	antecipação
defesa	confiança
mundo	medo
recusa	nojo
birra	raiva
colosso	surpresa
malemolência	tristeza
desejo	alegria
palpite	antecipação
salvaguarda	confiança
mundaréu	medo
refusão	nojo
perrice	raiva
embevecimento	surpresa
acabrunhamento	tristeza
distração	alegria
estimativa	antecipação
resguardo	confiança
amontoado	medo
refutação	nojo
nervoso	raiva
enlevo	surpresa
apatia	tristeza
diversão	alegria
orçamento	antecipação
cuidado	confiança
intensamente	medo
anorexia	nojo
aperreação	raiva
perfeição	surpresa
arrefecimento	tristeza
divertimento	alegria
cálculo	antecipação
preservação	confiança
muito	medo
cansaço	nojo
desespero	raiva
primor	surpresa
debilidade	tristeza
entretenimento	alegria
avaliação	antecipação
infalibilidade	confiança
bastante	medo
canseira	nojo
estorvo	raiva
correção	surpresa
derrotismo	tristeza
passatempo	alegria
estimação	antecipação
precaução	confiança
imenso	medo
fadiga	nojo
desconfiança	raiva
impecabilidade	surpresa
desconforto	tristeza
recreação	alegria
cômputo	antecipação
prudência	confiança
demais	medo
inapetência	nojo
acirramento	raiva
calêndula	surpresa
desinteresse	tristeza
gozo	alegria
cautela	antecipação
seguro	confiança
demasiado	medo
quebreira	nojo
apoquentação	raiva
dengue	surpresa
desvalor	tristeza
satisfazer	alegria
aviso	antecipação
reserva	confiança
demasiadamente	medo
sufocação	nojo
apuração	raiva
amor	surpresa
esgotamento	tristeza
comprazer	alegria
sobreaviso	antecipação
amparo	confiança
excessivamente	medo
saciedade	nojo
apuramento	raiva
paixão	surpresa
esvaecimento	tristeza
aprazer	alegria
advertência	antecipação
esteio	confiança
exageradamente	medo
displicência	nojo
arrelia	raiva
sedução	surpresa
frieza	tristeza
agradar	alegria
providência	antecipação
guarda-costas	confiança
tremor	medo
monotonia	nojo
arrenegação	raiva
prisão	surpresa
frio	tristeza
doçura	alegria
previdência	antecipação
guardião	confiança
caguira	medo
xarope	nojo
assomo	raiva
interesse	surpresa
indiferença	tristeza
complacência	alegria
diligência	antecipação
satélite	confiança
sobrosso	medo
anátema	nojo
aziúme	raiva
ofuscação	surpresa
inércia	tristeza
festa	alegria
oráculo	antecipação
vigilante	confiança
reverência	medo
abomínio	nojo
baba	raiva
denguice	surpresa
languidez	tristeza
aleluia	alegria
pressuposto	antecipação
vigia	confiança
obediência	medo
ressentimento	nojo
despeito	raiva
imã	surpresa
letargia	tristeza
rejubilação	alegria
horoscópio	antecipação
guarda	confiança
desassossego	medo
ardor	nojo
escamação	raiva
charme	surpresa
modorra	tristeza
sol	alegria
horóscopo	antecipação
sentinela	confiança
inquietude	medo
calor	nojo
fel	raiva
dengo	surpresa
preguiça	tristeza
rejúbilo	alegria
adivinhação	antecipação
acertamento	confiança
ameaça	medo
fervor	nojo
focagem	raiva
atração	surpresa
pusilanimidade	tristeza
empolgação	alegria
anúncio	antecipação
asserção	confiança
pontualidade	medo
arrojo	nojo
lua	raiva
atratividade	surpresa
remissão	tristeza
letícia	alegria
agouro	antecipação
asseveração	confiança
zelo	medo
audácia	nojo
calundu	raiva
glamour	surpresa
tepidez	tristeza
sorriso	alegria
divinação	antecipação
evidência	confiança
empenho	medo
bravura	nojo
torvação	raiva
carisma	surpresa
tibieza	tristeza
zombaria	alegria
sinal	antecipação
indubitabilidade	confiança
rigor	medo
brio	nojo
mau humor	raiva
impacto	surpresa
viuvez	tristeza
gargalhada	alegria
indício	antecipação
veracidade	confiança
escrúpulo	medo
disposição	nojo
implicação	raiva
desordem	surpresa
consternação	tristeza
gozação	alegria
indicação	antecipação
persuasão	confiança
salto	medo
intrepidez	nojo
implicância	raiva
bagunça	surpresa
decepção	tristeza
chacota	alegria
auspício	antecipação
convencimento	confiança
tremura	medo
ousadia	nojo
malevolência	raiva
alarme	surpresa
inconformação	tristeza
ridículo	alegria
sintoma	antecipação
com certeza	confiança
peladura	medo
valentia	nojo
garra	raiva
suspiro	surpresa
desprazimento	tristeza
hilaridade	alegria
bacorejo	antecipação
sugestionamento	confiança
acovardamento	medo
enojamento	nojo
anseio	raiva
trepidação	surpresa
malgrado	tristeza
risada	alegria
melhoria	antecipação
princípio	confiança
intranquilidade	medo
chateação	nojo
avidez	raiva
estremecimento	surpresa
abate	tristeza
judiaria	alegria
melhora	antecipação
ideia	confiança
intimidação	medo
ambição	nojo
sofreguidão	raiva
balanço	surpresa
nirvana	tristeza
judiação	alegria
dianteira	antecipação
ideal	confiança
angústia	medo
vazio	nojo
fome	raiva
oscilação	surpresa
baixa	tristeza
consentimento	alegria
vantagem	antecipação
ideologia	confiança
consumição	medo
morte	nojo
apetite	raiva
sacudida	surpresa
rebaixamento	tristeza
concordância	alegria
progresso	antecipação
concepção	confiança
mortificação	medo
anojamento	nojo
arroubo	raiva
sacudidela	surpresa
enfraquecimento	tristeza
anuência	alegria
prosperidade	antecipação
conceito	confiança
hesitação	medo
solda	nojo
acesso	raiva
abalamento	surpresa
abaixamento	tristeza
aprovação	alegria
desenvolvimento	antecipação
opinião	confiança
suspeição	medo
noite	nojo
moda	raiva
estremeção	surpresa
dedução	tristeza
permissão	alegria
aperfeiçoamento	antecipação
valor	confiança
cisma	medo
cipreste	nojo
voga	raiva
frêmito	surpresa
desconto	tristeza
assentimento	alegria
aumento	antecipação
juízo	confiança
captação	medo
crepe	nojo
amolação	raiva
abalada	surpresa
diminuição	tristeza
aquiescência	alegria
vale	antecipação
pensamento	confiança
assimilação	medo
condoimento	nojo
enguiço	raiva
debandada	surpresa
humilhação	tristeza
aceitação	alegria
civilização	antecipação
consciência	confiança
entendimento	medo
compadecimento	nojo
feitiço	raiva
fuga	surpresa
palerma	tristeza
beneplácito	alegria
crescimento	antecipação
enforcamento	confiança
percepção	medo
compaixão	nojo
mau-olhado	raiva
retirada	surpresa
caimento	tristeza
cortesia	alegria
proveito	antecipação
cadafalso	confiança
absorção	medo
piedade	nojo
quebranto	raiva
partida	surpresa
decadência	tristeza
educação	alegria
aproveitamento	antecipação
patíbulo	confiança
compreensão	medo
comiseração	nojo
incompatibilidade	raiva
saída	surpresa
declínio	tristeza
gentileza	alegria
evolução	antecipação
guilhotina	confiança
apoderamento	medo
constrição	nojo
enfurecimento	raiva
movimentação	surpresa
ruína	tristeza
delicadeza	alegria
indiscrição	antecipação
ardil	confiança
apoderação	medo
enternecimento	nojo
briga	raiva
baque	surpresa
escuridão	tristeza
cordialidade	alegria
melhoramento	antecipação
armadilha	confiança
apresamento	medo
miseração	nojo
desavença	raiva
tranco	surpresa
baixeza	tristeza
amabilidade	alegria
avançamento	antecipação
cilada	confiança
aprisionamento	medo
misericórdia	nojo
luta	raiva
ataque	surpresa
anemia	tristeza
graciosidade	alegria
avançada	antecipação
emboscada	confiança
apropriação	medo
abalançar	nojo
rixa	raiva
moção	surpresa
astenia	tristeza
afabilidade	alegria
frente	antecipação
laço	confiança
arresto	medo
romanear	nojo
avaria	raiva
desinquietação	surpresa
estrago	tristeza
urbanidade	alegria
vanguarda	antecipação
ancinho	confiança
captura	medo
sopesar	nojo
defeito	raiva
debilitação	surpresa
fossa	tristeza
fineza	alegria
ascensão	antecipação
forquilha	confiança
confiscação	medo
avaliar	nojo
falha	raiva
quebra	surpresa
diferença	tristeza
lhaneza	alegria
progressão	antecipação
garfo	confiança
confisco	medo
apreciar	nojo
agressão	raiva
depauperamento	surpresa
redução	tristeza
atenção	alegria
melhorada	antecipação
forcado	confiança
detenção	medo
analisar	nojo
hostilização	raiva
dissuasão	surpresa
desgaste	tristeza
gratificação	alegria
upgrade	antecipação
forqueta	confiança
embargo	medo
considerar	nojo
ofensa	raiva
tumulto	surpresa
matança	tristeza
prêmio	alegria
ampliação	antecipação
botequim	confiança
sequestro	medo
estimar	nojo
brutalidade	raiva
convulsão	surpresa
lentidão	tristeza
gorjeta	alegria
acréscimo	antecipação
vendinha de roça	confiança
afligimento	medo
estudar	nojo
belicosidade	raiva
efervescência	surpresa
frouxidão	tristeza
presente	alegria
acrescentamento	antecipação
credo	confiança
tormenta	medo
examinar	nojo
dinamismo	raiva
terremoto	surpresa
torpor	tristeza
favor	alegria
abreviatura	antecipação
credulidade	confiança
atormentamento	medo
observar	nojo
empreendimento	raiva
sismo	surpresa
opressão	tristeza
caixinha	alegria
sigla	antecipação
dogma	confiança
dedicação	medo
ponderar	nojo
atividade	raiva
cataclismo	surpresa
aniquilamento	tristeza
galardão	alegria
acrônimo	antecipação
doutrina	confiança
esmero	medo
presumir	nojo
recrudescimento	raiva
abalroamento	surpresa
atimia	tristeza
carinhos	alegria
miniatura	antecipação
religião	confiança
capricho	medo
imaginar	nojo
desapontamento	raiva
batida	surpresa
derrubada	tristeza
afagos	alegria
contração	antecipação
crédito	confiança
solicitude	medo
calcular	nojo
desaponto	raiva
abalroação	surpresa
descaimento	tristeza
festas	alegria
encolhimento	antecipação
fidúcia	confiança
desvelo	medo
conjecturar	nojo
desencanto	raiva
colisão	surpresa
desvalorização	tristeza
festinhas	alegria
encurtamento	antecipação
fieza	confiança
devoção	medo
prever	nojo
desencantamento	raiva
concussão	surpresa
lombeira	tristeza
mimos	alegria
resumo	antecipação
fiúza	confiança
obsessão	medo
supor	nojo
desilusão	raiva
embate	surpresa
marasmo	tristeza
brinco-de-princesa	alegria
síntese	antecipação
insuspeição	confiança
fixação	medo
influenciar	nojo
fracasso	raiva
encontrão	surpresa
morbidez	tristeza
lágrima	alegria
sumário	antecipação
comprovação	confiança
compulsão	medo
atuar	nojo
malogro	raiva
encontro	surpresa
nostalgia	tristeza
brinde	alegria
compêndio	antecipação
confirmação	confiança
obcecação	medo
induzir	nojo
falhanço	raiva
esbarrão	surpresa
quebradeira	tristeza
oferta	alegria
resenha	antecipação
corroboração	confiança
fanatismo	medo
influir	nojo
naufrágio	raiva
esbarro	surpresa
quebramento	tristeza
agasalho	alegria
epílogo	antecipação
demostração	confiança
mania	medo
instigar	nojo
antagonismo	raiva
pancada	surpresa
quebrantamento	tristeza
dádiva	alegria
epítome	antecipação
prova	confiança
preconceito	medo
intervir	nojo
desafeição	raiva
recontro	surpresa
amortização	tristeza
mimo	alegria
súmula	antecipação
ratificação	confiança
prejulgamento	medo
motivar	nojo
pontinha	raiva
solavanco	surpresa
bônus	tristeza
lembrança	alegria
medida	antecipação
testemunho	confiança
discriminação	medo
sugestionar	nojo
quizília	raiva
topada	surpresa
inanição	tristeza
volúpia	alegria
premeditação	antecipação
validação	confiança
estereótipo	medo
recair	nojo
teiró	raiva
toque	surpresa
subtração	tristeza
bobagem	alegria
preparação	antecipação
verificação	confiança
prejuízo	medo
incidir	nojo
alergia	raiva
trombada	surpresa
umbigo	tristeza
comodidade	alegria
preparativo	antecipação
compromisso	confiança
prenoção	medo
apertar	nojo
contragosto	raiva
conflito	surpresa
decremento	tristeza
prenda	alegria
preparo	antecipação
promessa	confiança
antepaixão	medo
calcar	nojo
quizila	raiva
desentendimento	surpresa
depleção	tristeza
vibração	alegria
cismo	antecipação
legitimidade	confiança
arquejo	medo
estender-se	nojo
imprecação	raiva
discussão	surpresa
adelgaçamento	tristeza
