	0
alegria	alegria
medo	medo
nojo	nojo
raiva	raiva
surpresa	surpresa
tristeza	tristeza
contentamento	alegria
pavor	medo
asco	nojo
fúria	raiva
espanto	surpresa
infelicidade	tristeza
satisfação	alegria
fobia	medo
aversão	nojo
ira	raiva
admiração	surpresa
desânimo	tristeza
felicidade	alegria
horror	medo
náusea	nojo
cólera	raiva
assombro	surpresa
tristura	tristeza
prazer	alegria
terror	medo
enjoo	nojo
irritação	raiva
pasmo	surpresa
descontentamento	tristeza
regozijo	alegria
pânico	medo
repugnância	nojo
ódio	raiva
maravilha	surpresa
abatimento	tristeza
júbilo	alegria
temor	medo
repulsão	nojo
gana	raiva
maravilhamento	surpresa
melancolia	tristeza
riso	alegria
susto	medo
repulsa	nojo
furor	raiva
sobressalto	surpresa
desalento	tristeza
bom humor	alegria
ojeriza	medo
fastio	nojo
zanga	raiva
abalo	surpresa
desolação	tristeza
agrado	alegria
amedrontamento	medo
abominação	nojo
agressividade	raiva
choque	surpresa
desconsolo	tristeza
regalo	alegria
receio	medo
animosidade	nojo
sanha	raiva
comoção	surpresa
insatisfação	tristeza
animação	alegria
apreensão	medo
enojo	nojo
exasperação	raiva
perturbação	surpresa
esmorecimento	tristeza
gosto	alegria
preocupação	medo
engulho	nojo
frustração	raiva
emoção	surpresa
prostração	tristeza
bem-estar	alegria
ansiedade	medo
antojo	nojo
indignação	raiva
estranheza	surpresa
depressão	tristeza
comprazimento	alegria
inquietação	medo
luto	nojo
antipatia	raiva
espavento	surpresa
desesperança	tristeza
contento	alegria
incerteza	medo
dó	nojo
odiosidade	raiva
fascínio	surpresa
mágoa	tristeza
deleite	alegria
dúvida	medo
pesar	nojo
execração	raiva
imprevisto	surpresa
desgosto	tristeza
deleitação	alegria
covardia	medo
crepe	nojo
desprezo	raiva
inesperado	surpresa
sofrimento	tristeza
deleitamento	alegria
fraqueza	medo
cipreste	nojo
rancor	raiva
repentino	surpresa
aflição	tristeza
aprazimento	alegria
frouxidão	medo
vergonha	nojo
ressentimento	raiva
súbito	surpresa
angústia	tristeza
exultação	alegria
poltronaria	medo
pudor	nojo
hidrofobia	raiva
presente	surpresa
consternação	tristeza
entusiasmo	alegria
pusilanimidade	medo
recato	nojo
danação	raiva
brinde	surpresa
dissabor	tristeza
jovialidade	alegria
poltronice	medo
decoro	nojo
moléstia	raiva
mimo	surpresa
amargura	tristeza
enlevo	alegria
ignávia	medo
pejo	nojo
desejo	raiva
lembrança	surpresa
dor	tristeza
euforia	alegria
alarma	medo
ânsia	nojo
frenesi	raiva
estupefação	surpresa
azar	tristeza
alacridade	alegria
cagaço	medo
mal-estar	nojo
impetuosidade	raiva
perplexidade	surpresa
desgraça	tristeza
desfastio	alegria
estarrecimento	medo
repelência	nojo
repelo	raiva
estuporação	surpresa
fatalidade	tristeza
jubilidade	alegria
intolerância	medo
animadversão	nojo
violência	raiva
estranhez	surpresa
desdita	tristeza
ledice	alegria
crueldade	medo
desafeto	nojo
onda	raiva
confusão	surpresa
desventura	tristeza
desculpa	alegria
monstruosidade	medo
embirração	nojo
alteração	raiva
alvoroço	surpresa
infortúnio	tristeza
escusa	alegria
barbaridade	medo
hostilidade	nojo
aborrecimento	raiva
arrebatamento	surpresa
misantropia	tristeza
justificativa	alegria
atrocidade	medo
inimizade	nojo
loucura	raiva
sensação	surpresa
aborto	tristeza
motivo	alegria
hediondez	medo
malquerença	nojo
impulso	raiva
deslumbramento	surpresa
mal	tristeza
razão	alegria
selvajaria	medo
malquerer	nojo
ímpeto	raiva
deslumbre	surpresa
adversidade	tristeza
explicação	alegria
desumanidade	medo
abuso	nojo
borrasca	raiva
encantamento	surpresa
calamidade	tristeza
compensação	alegria
bestialidade	medo
agonia	nojo
exaltação	raiva
encanto	surpresa
catástrofe	tristeza
devolução	alegria
crime	medo
estuação	nojo
excitação	raiva
êxtase	surpresa
revés	tristeza
indenização	alegria
feiura	medo
revolução	nojo
acromania	raiva
fascinação	surpresa
tragédia	tristeza
paga	alegria
monstro	medo
entojo	nojo
assanhamento	raiva
respeito	surpresa
tormento	tristeza
pagamento	alegria
bicho	medo
afronta	nojo
embravecimento	raiva
consideração	surpresa
mesquinhez	tristeza
recompensa	alegria
diabo	medo
naupatia	nojo
encarniçamento	raiva
veneração	surpresa
contratempo	tristeza
reembolso	alegria
mostrengo	medo
peso	nojo
estrilo	raiva
adoração	surpresa
intempérie	tristeza
remuneração	alegria
canhão	medo
tontura	nojo
repente	raiva
afeição	surpresa
castigo	tristeza
ressarcimento	alegria
bruxa	medo
enfado	nojo
rompante	raiva
apreço	surpresa
volta	tristeza
restituição	alegria
bruaca	medo
enfaro	nojo
veemência	raiva
contemplação	surpresa
lástima	tristeza
retribuição	alegria
xaveco	medo
tédio	nojo
voracidade	raiva
deferência	surpresa
golpe	tristeza
desagravo	alegria
bagulho	medo
resistência	nojo
tesão	raiva
estima	surpresa
derrota	tristeza
expiação	alegria
jararaca	medo
oposição	nojo
elã	raiva
simpatia	surpresa
sorte	tristeza
reparação	alegria
bucho	medo
objeção	nojo
pena	raiva
assombração	surpresa
negrura	tristeza
retratação	alegria
desagrado	medo
revolta	nojo
punição	raiva
visão	surpresa
negrume	tristeza
bem-aventurança	alegria
desprazer	medo
dificuldade	nojo
vingança	raiva
atordoamento	surpresa
miséria	tristeza
ventura	alegria
contrariedade	medo
torpeza	nojo
cólera-morbo	raiva
fantasma	surpresa
sentimento	tristeza
dita	alegria
amofinação	medo
rejeição	nojo
mordexim	raiva
fenômeno	surpresa
moleza	tristeza
fortuna	alegria
padecimento	medo
esquivança	nojo
descontrole	raiva
aparição	surpresa
atribulação	tristeza
sucesso	alegria
dinheirão	medo
repúdio	nojo
exacerbação	raiva
espetáculo	surpresa
caiporismo	tristeza
êxito	alegria
dinheirada	medo
escândalo	nojo
agitação	raiva
milagre	surpresa
casmurrice	tristeza
triunfo	alegria
dinheirama	medo
expulsão	nojo
força	raiva
pasmaceira	surpresa
hipocondria	tristeza
vitória	alegria
exorbitância	medo
repressão	nojo
feridade	raiva
prodígio	surpresa
insucesso	tristeza
acerto	alegria
batelada	medo
recalque	nojo
fereza	raiva
estupefato	surpresa
macaca	tristeza
glória	alegria
monte	medo
asca	nojo
braveza	raiva
boquiaberto	surpresa
mofina	tristeza
congratulações	alegria
montão	medo
enjeitamento	nojo
ferocidade	raiva
pasmado	surpresa
morrinha	tristeza
felicitações	alegria
quantidade	medo
entejo	nojo
flagelo	raiva
admirado	surpresa
suicídio	tristeza
cumprimentos	alegria
abundância	medo
estranhamento	nojo
mau	raiva
espantado	surpresa
taciturnidade	tristeza
gáudio	alegria
enxurrada	medo
contestação	nojo
praga	raiva
estupefacto	surpresa
transtorno	tristeza
jubilação	alegria
porção	medo
denegação	nojo
nervosismo	raiva
perplexo	surpresa
urucubaca	tristeza
delícia	alegria
profusão	medo
divergência	nojo
neurastenia	raiva
surpreendido	surpresa
vicissitude	tristeza
distração	alegria
série	medo
impugnação	nojo
estresse	raiva
surpreso	surpresa
zica	tristeza
diversão	alegria
chorrilho	medo
nega	nojo
stress	raiva
absorto	surpresa
tanglomanglo	tristeza
divertimento	alegria
mundo	medo
negaça	nojo
droga	raiva
embasbacado	surpresa
malemolência	tristeza
entretenimento	alegria
mundaréu	medo
negação	nojo
grosseiro	raiva
atônito	surpresa
acabrunhamento	tristeza
passatempo	alegria
amontoado	medo
negamento	nojo
agastamento	raiva
portento	surpresa
apatia	tristeza
recreação	alegria
intensamente	medo
recusa	nojo
azedume	raiva
colosso	surpresa
arrefecimento	tristeza
gozo	alegria
muito	medo
refusão	nojo
birra	raiva
embevecimento	surpresa
debilidade	tristeza
satisfazer	alegria
bastante	medo
refutação	nojo
perrice	raiva
perfeição	surpresa
derrotismo	tristeza
comprazer	alegria
imenso	medo
anorexia	nojo
nervoso	raiva
primor	surpresa
desconforto	tristeza
aprazer	alegria
demais	medo
cansaço	nojo
aperreação	raiva
apuro	surpresa
desespero	tristeza
agradar	alegria
demasiado	medo
canseira	nojo
impaciência	raiva
precisão	surpresa
desinteresse	tristeza
doçura	alegria
demasiadamente	medo
fadiga	nojo
estorvo	raiva
correção	surpresa
desvalor	tristeza
vontade	alegria
excessivamente	medo
inapetência	nojo
desconfiança	raiva
impecabilidade	surpresa
esgotamento	tristeza
complacência	alegria
exageradamente	medo
quebreira	nojo
acirramento	raiva
calêndula	surpresa
esvaecimento	tristeza
festa	alegria
tremor	medo
sufocação	nojo
apoquentação	raiva
dengue	surpresa
frieza	tristeza
aleluia	alegria
caguira	medo
saciedade	nojo
apuração	raiva
amor	surpresa
frio	tristeza
rejubilação	alegria
sobrosso	medo
displicência	nojo
apuramento	raiva
paixão	surpresa
indiferença	tristeza
sol	alegria
reverência	medo
monotonia	nojo
arrelia	raiva
sedução	surpresa
inércia	tristeza
rejúbilo	alegria
obediência	medo
xarope	nojo
arrenegação	raiva
prisão	surpresa
languidez	tristeza
empolgação	alegria
desassossego	medo
anátema	nojo
assomo	raiva
interesse	surpresa
letargia	tristeza
letícia	alegria
inquietude	medo
abomínio	nojo
aziúme	raiva
ofuscação	surpresa
modorra	tristeza
sorriso	alegria
ameaça	medo
prevenção	nojo
baba	raiva
denguice	surpresa
preguiça	tristeza
zombaria	alegria
pontualidade	medo
ardor	nojo
despeito	raiva
imã	surpresa
remissão	tristeza
gargalhada	alegria
zelo	medo
calor	nojo
escamação	raiva
charme	surpresa
tepidez	tristeza
gozação	alegria
diligência	medo
fervor	nojo
fel	raiva
dengo	surpresa
tibieza	tristeza
chacota	alegria
empenho	medo
arrojo	nojo
focagem	raiva
atração	surpresa
viuvez	tristeza
ridículo	alegria
rigor	medo
audácia	nojo
lua	raiva
atratividade	surpresa
decepção	tristeza
hilaridade	alegria
escrúpulo	medo
bravura	nojo
calundu	raiva
glamour	surpresa
inconformação	tristeza
risada	alegria
cuidado	medo
brio	nojo
torvação	raiva
carisma	surpresa
desprazimento	tristeza
judiaria	alegria
salto	medo
coragem	nojo
mau humor	raiva
impacto	surpresa
malgrado	tristeza
judiação	alegria
tremura	medo
determinação	nojo
implicação	raiva
desordem	surpresa
abate	tristeza
consentimento	alegria
alarme	medo
disposição	nojo
implicância	raiva
bagunça	surpresa
nirvana	tristeza
concordância	alegria
peladura	medo
intrepidez	nojo
malevolência	raiva
roldão	surpresa
baixa	tristeza
anuência	alegria
acovardamento	medo
ousadia	nojo
garra	raiva
suspiro	surpresa
rebaixamento	tristeza
aprovação	alegria
intranquilidade	medo
valentia	nojo
anseio	raiva
trepidação	surpresa
enfraquecimento	tristeza
permissão	alegria
intimidação	medo
enojamento	nojo
avidez	raiva
estremecimento	surpresa
abaixamento	tristeza
assentimento	alegria
consumição	medo
chateação	nojo
sofreguidão	raiva
balanço	surpresa
dedução	tristeza
aquiescência	alegria
mortificação	medo
ambição	nojo
fome	raiva
oscilação	surpresa
desconto	tristeza
aceitação	alegria
pressentimento	medo
vazio	nojo
apetite	raiva
sacudida	surpresa
diminuição	tristeza
beneplácito	alegria
hesitação	medo
morte	nojo
arroubo	raiva
sacudidela	surpresa
humilhação	tristeza
cortesia	alegria
suspeita	medo
anojamento	nojo
acesso	raiva
abalamento	surpresa
palerma	tristeza
educação	alegria
suspeição	medo
solda	nojo
moda	raiva
estremeção	surpresa
caimento	tristeza
gentileza	alegria
cisma	medo
noite	nojo
voga	raiva
frêmito	surpresa
decadência	tristeza
delicadeza	alegria
captação	medo
condoimento	nojo
amolação	raiva
abalada	surpresa
declínio	tristeza
cordialidade	alegria
assimilação	medo
compadecimento	nojo
enguiço	raiva
debandada	surpresa
ruína	tristeza
amabilidade	alegria
entendimento	medo
compaixão	nojo
feitiço	raiva
fuga	surpresa
escuridão	tristeza
graciosidade	alegria
percepção	medo
piedade	nojo
mau-olhado	raiva
retirada	surpresa
baixeza	tristeza
afabilidade	alegria
absorção	medo
comiseração	nojo
quebranto	raiva
partida	surpresa
anemia	tristeza
urbanidade	alegria
compreensão	medo
constrição	nojo
incompatibilidade	raiva
saída	surpresa
astenia	tristeza
fineza	alegria
apoderamento	medo
enternecimento	nojo
enfurecimento	raiva
movimentação	surpresa
estrago	tristeza
lhaneza	alegria
apoderação	medo
miseração	nojo
briga	raiva
baque	surpresa
fossa	tristeza
atenção	alegria
apresamento	medo
misericórdia	nojo
desavença	raiva
tranco	surpresa
diferença	tristeza
gratificação	alegria
aprisionamento	medo
abalançar	nojo
luta	raiva
ataque	surpresa
redução	tristeza
prêmio	alegria
apropriação	medo
romanear	nojo
rixa	raiva
moção	surpresa
desgaste	tristeza
gorjeta	alegria
arresto	medo
sopesar	nojo
avaria	raiva
desinquietação	surpresa
matança	tristeza
favor	alegria
captura	medo
avaliar	nojo
defeito	raiva
debilitação	surpresa
lentidão	tristeza
caixinha	alegria
confiscação	medo
apreciar	nojo
falha	raiva
quebra	surpresa
torpor	tristeza
galardão	alegria
confisco	medo
analisar	nojo
agressão	raiva
depauperamento	surpresa
opressão	tristeza
carinhos	alegria
detenção	medo
considerar	nojo
hostilização	raiva
dissuasão	surpresa
aniquilamento	tristeza
afagos	alegria
embargo	medo
estimar	nojo
ofensa	raiva
tumulto	surpresa
atimia	tristeza
festas	alegria
sequestro	medo
estudar	nojo
dureza	raiva
convulsão	surpresa
derrubada	tristeza
festinhas	alegria
afligimento	medo
examinar	nojo
brutalidade	raiva
efervescência	surpresa
descaimento	tristeza
mimos	alegria
tormenta	medo
observar	nojo
belicosidade	raiva
terremoto	surpresa
desvalorização	tristeza
brinco-de-princesa	alegria
atormentamento	medo
ponderar	nojo
dinamismo	raiva
sismo	surpresa
lombeira	tristeza
lágrima	alegria
precaução	medo
presumir	nojo
energia	raiva
cataclismo	surpresa
marasmo	tristeza
oferta	alegria
dedicação	medo
imaginar	nojo
empreendimento	raiva
abalroamento	surpresa
morbidez	tristeza
resguardo	alegria
esmero	medo
calcular	nojo
atividade	raiva
batida	surpresa
nostalgia	tristeza
agasalho	alegria
capricho	medo
conjecturar	nojo
recrudescimento	raiva
abalroação	surpresa
quebradeira	tristeza
dádiva	alegria
solicitude	medo
prever	nojo
desapontamento	raiva
colisão	surpresa
quebramento	tristeza
volúpia	alegria
aplicação	medo
supor	nojo
desaponto	raiva
concussão	surpresa
quebrantamento	tristeza
bobagem	alegria
desvelo	medo
influenciar	nojo
desencanto	raiva
embate	surpresa
amortização	tristeza
comodidade	alegria
devoção	medo
atuar	nojo
desencantamento	raiva
encontrão	surpresa
bônus	tristeza
prenda	alegria
obsessão	medo
induzir	nojo
desilusão	raiva
encontro	surpresa
inanição	tristeza
vibração	alegria
fixação	medo
influir	nojo
fracasso	raiva
esbarrão	surpresa
subtração	tristeza
algazarra	alegria
compulsão	medo
instigar	nojo
malogro	raiva
esbarro	surpresa
umbigo	tristeza
movimento	alegria
obcecação	medo
intervir	nojo
falhanço	raiva
pancada	surpresa
decremento	tristeza
bulício	alegria
fanatismo	medo
motivar	nojo
naufrágio	raiva
recontro	surpresa
depleção	tristeza
afã	alegria
pensamento	medo
sugestionar	nojo
antagonismo	raiva
solavanco	surpresa
adelgaçamento	tristeza
vigor	alegria
mania	medo
recair	nojo
desafeição	raiva
topada	surpresa
saudade	tristeza
gás	alegria
preconceito	medo
incidir	nojo
pontinha	raiva
toque	surpresa
banzo	tristeza
alento	alegria
prejulgamento	medo
apertar	nojo
quizília	raiva
trombada	surpresa
malacia	tristeza
vivacidade	alegria
discriminação	medo
calcar	nojo
teiró	raiva
conflito	surpresa
destruição	tristeza
brilho	alegria
estereótipo	medo
estender-se	nojo
alergia	raiva
desentendimento	surpresa
assolação	tristeza
vida	alegria
prejuízo	medo
imprensar	nojo
contragosto	raiva
discussão	surpresa
destroços	tristeza
viveza	alegria
prenoção	medo
oprimir	nojo
quizila	raiva
batalha	surpresa
devastação	tristeza
alma	alegria
antepaixão	medo
premer	nojo
imprecação	raiva
combate	surpresa
degradação	tristeza
estímulo	alegria
arquejo	medo
prensar	nojo
desdém	raiva
enfrentamento	surpresa
nuvem	tristeza
encorajamento	alegria
estertor	medo
pressionar	nojo
desconsideração	raiva
peleja	surpresa
desconsolação	tristeza
apoio	alegria
vasca	medo
sobrecarregar	nojo
desapreço	raiva
pugna	surpresa
sufoco	tristeza
incentivo	alegria
aspiração	medo
abater	nojo
descaso	raiva
eletrochoque	surpresa
pecado	tristeza
incitação	alegria
ofego	medo
aborrecer	nojo
desatenção	raiva
descarga	surpresa
trauma	tristeza
incitamento	alegria
anelo	medo
chatear	nojo
menosprezo	raiva
contusão	surpresa
desmaio	tristeza
acoroçoamento	alegria
anelação	medo
desagradar	nojo
menoscabo	raiva
mossa	surpresa
desfalecimento	tristeza
favorecimento	alegria
ebulição	medo
descontentar	nojo
depreciação	raiva
motim	surpresa
síncope	tristeza
fomentação	alegria
ralação	medo
desgostar	nojo
vilipêndio	raiva
rebelião	surpresa
amortecimento	tristeza
fomento	alegria
dubiedade	medo
estorvar	nojo
detração	raiva
levantamento	surpresa
exaustão	tristeza
influxo	alegria
ambiguidade	medo
importunar	nojo
pouco-caso	raiva
levante	surpresa
extenuação	tristeza
aparecimento	alegria
dubiez	medo
incomodar	nojo
desrespeito	raiva
abano	surpresa
estafa	tristeza
surgimento	alegria
imprecisão	medo
maçar	nojo
desacato	raiva
abanão	surpresa
esfalfamento	tristeza
irrupção	alegria
indecisão	medo
magoar	nojo
negligência	raiva
distúrbio	surpresa
relaxamento	tristeza
eclosão	alegria
indefinição	medo
perturbar	nojo
desfavor	raiva
conturbação	surpresa
relaxação	tristeza
paladar	alegria
indeterminação	medo
apiedar	nojo
desamor	raiva
caos	surpresa
letargo	tristeza
gustação	alegria
insegurança	medo
comiserar	nojo
desculto	raiva
crise	surpresa
langor	tristeza
sabor	alegria
interrogação	medo
comover	nojo
desprendimento	raiva
barulho	surpresa
atonia	tristeza
palato	alegria
irresolução	medo
compadecer	nojo
abandono	raiva
aperto	surpresa
lassidão	tristeza
saibo	alegria
vacilação	medo
compungir	nojo
desapego	raiva
embaraço	surpresa
entorpecimento	tristeza
apetência	alegria
ceticismo	medo
condoer	nojo
alheamento	raiva
atrapalhação	surpresa
indolência	tristeza
aptidão	alegria
descrença	medo
consternar	nojo
renúncia	raiva
desorientação	surpresa
inatividade	tristeza
propensão	alegria
incredulidade	medo
contristar	nojo
abnegação	raiva
irregularidade	surpresa
concavidade	tristeza
predileção	alegria
pirronismo	medo
emocionar	nojo
isenção	raiva
problema	surpresa
cavidade	tristeza
predisposição	alegria
suspicácia	medo
enternecer	nojo
relutância	raiva
erro	surpresa
cova	tristeza
inclinação	alegria
melindre	medo
entristecer	nojo
queixa	raiva
falta	surpresa
buraco	tristeza
tendência	alegria
obstáculo	medo
molestar	nojo
ciúme	raiva
desvio	surpresa
sulco	tristeza
preferência	alegria
questão	medo
penalizar	nojo
ressaibo	raiva
disfunção	surpresa
desnível	tristeza
queda	alegria
pergunta	medo
sensibilizar	nojo
higrofobia	raiva
desarranjo	surpresa
recessão	tristeza
fraco	alegria
sem dúvida	medo
tocar	nojo
trapalhada	raiva
desarmonia	surpresa
estagnação	tristeza
pendor	alegria
cobardia	medo
equilibrar-se	nojo
condenação	raiva
mudança	surpresa
paralisação	tristeza
habilidade	alegria
tremelique	medo
arrependimento	nojo
maldição	raiva
modificação	surpresa
definhamento	tristeza
vocação	alegria
maricagem	medo
compunção	nojo
perda	raiva
transformação	surpresa
decréscimo	tristeza
veia	alegria
adinamia	medo
contrição	nojo
perdição	raiva
desequilíbrio	surpresa
decrescimento	tristeza
sensibilidade	alegria
fragilidade	medo
pesadume	nojo
doença	raiva
vertigem	surpresa
atenuação	tristeza
bom gosto	alegria
depauperação	medo
remorso	nojo
achaque	raiva
estonteamento	surpresa
minoração	tristeza
elegância	alegria
fraqueira	medo
pepino	nojo
indisposição	raiva
impressão	surpresa
apoucamento	tristeza
finura	alegria
acobardamento	medo
fumo	nojo
ziguizira	raiva
turbação	surpresa
desengano	tristeza
refinamento	alegria
desbrio	medo
braçal	nojo
ziquizira	raiva
esquisitice	surpresa
desesperação	tristeza
requinte	alegria
tibiez	medo
constrangimento	nojo
dodói	raiva
extravagância	surpresa
desperança	tristeza
discrição	alegria
timidez	medo
vexame	nojo
enfermidade	raiva
excentricidade	surpresa
contristação	tristeza
harmonia	alegria
vício	medo
desonra	nojo
adoecimento	raiva
bizarria	surpresa
condolência	tristeza
maneira	alegria
deficiência	medo
enxovalho	nojo
mazela	raiva
originalidade	surpresa
pêsames	tristeza
modo	alegria
deformidade	medo
opróbrio	nojo
afecção	raiva
singularidade	surpresa
inveja	tristeza
jeito	alegria
desdouro	medo
ignomínia	nojo
carregação	raiva
espécie	surpresa
dor de cotovelo	tristeza
estilo	alegria
deslustre	medo
demérito	nojo
incômodo	raiva
esquivamento	surpresa
cobiça	tristeza
forma	alegria
eiva	medo
descrédito	nojo
morbo	raiva
esquivez	surpresa
cupidez	tristeza
critério	alegria
imperfeição	medo
aviltamento	nojo
querer	raiva
esquiveza	surpresa
marca	tristeza
opinião	alegria
ineficácia	medo
desdoiro	nojo
tentação	raiva
pompa	surpresa
mancha	tristeza
discernimento	alegria
ineficiência	medo
labéu	nojo
fantasia	raiva
luxo	surpresa
nódoa	tristeza
escolha	alegria
inutilidade	medo
acanhamento	nojo
libido	raiva
ostentação	surpresa
sinal	tristeza
juízo	alegria
mácula	medo
introversão	nojo
lascívia	raiva
aparato	surpresa
impureza	tristeza
alvitre	alegria
senão	medo
retraimento	nojo
lubricidade	raiva
magia	surpresa
chatice	tristeza
arbítrio	alegria
indefensabilidade	medo
reserva	nojo
concupiscência	raiva
magnetismo	surpresa
má sorte	tristeza
mercê	alegria
vulnerabilidade	medo
recolhimento	nojo
excitamento	raiva
hipnotismo	surpresa
desastre	tristeza
bel-prazer	alegria
bambeza	medo
encolhimento	nojo
sede	raiva
circunstancial	surpresa
tribulação	tristeza
talante	alegria
largueza	medo
rubor	nojo
ganância	raiva
casual	surpresa
desfortúnio	tristeza
opção	alegria
folga	medo
decência	nojo
febre	raiva
acidental	surpresa
desgraceira	tristeza
molhadela	alegria
morosidade	medo
compostura	nojo
apego	raiva
desacautelado	surpresa
amuo	tristeza
conforto	alegria
acídia	medo
virtude	nojo
aferro	raiva
extraordinário	surpresa
agrura	tristeza
aconchego	alegria
desídia	medo
moralidade	nojo
propósito	raiva
fortuito	surpresa
penar	tristeza
saúde	alegria
laxação	medo
seriedade	nojo
pretensão	raiva
impensado	surpresa
suplício	tristeza
segurança	alegria
subtileza	medo
pudicícia	nojo
intenção	raiva
impensável	surpresa
martírio	tristeza
tranquilidade	alegria
palidez	medo
honra	nojo
intento	raiva
imprevisível	surpresa
calvário	tristeza
beatitude	alegria
desleixo	medo
amor-próprio	nojo
intuito	raiva
inadvertido	surpresa
prova	tristeza
bem	alegria
desmazelo	medo
dignidade	nojo
tenção	raiva
incalculado	surpresa
provação	tristeza
conveniência	alegria
clínico	medo
orgulho	nojo
desígnio	raiva
inopinado	surpresa
tortura	tristeza
oásis	alegria
terapeuta	medo
integridade	nojo
alvo	raiva
inopino	surpresa
penúria	tristeza
independência	alegria
doutor	medo
pundonor	nojo
objetivo	raiva
ocasional	surpresa
pobreza	tristeza
prosperidade	alegria
esculápio	medo
dormideira	nojo
objeto	raiva
surpreendente	surpresa
paciência	tristeza
benevolência	alegria
facultativo	medo
castidade	nojo
projeto	raiva
acaso	surpresa
resignação	tristeza
benignidade	alegria
galeno	medo
honestidade	nojo
veleidade	raiva
acidente	surpresa
conformação	tristeza
condescendência	alegria
iátrico	medo
inocência	nojo
veneta	raiva
circunstância	surpresa
conformidade	tristeza
conteúdo	alegria
medicinal	medo
modéstia	nojo
desvario	raiva
episódio	surpresa
tolerância	tristeza
amenidade	alegria
medical	medo
pureza	nojo
devaneio	raiva
eventualidade	surpresa
tensão	tristeza
prazimento	alegria
medicamentoso	medo
despretensão	nojo
sonho	raiva
incidente	surpresa
pressa	tristeza
sanção	alegria
recurso	medo
singeleza	nojo
obstinação	raiva
lance	surpresa
percalço	tristeza
jucundidade	alegria
remédio	medo
cautela	nojo
teimosia	raiva
abrupto	surpresa
óbice	tristeza
calma	alegria
aviso	medo
almejo	nojo
delírio	raiva
adormecimento	surpresa
azarão	tristeza
despreocupação	alegria
balbúrdia	medo
comichão	nojo
alucinação	raiva
dormência	surpresa
baldão	tristeza
otimismo	alegria
brado	medo
necessidade	nojo
correria	raiva
perplexão	surpresa
acontecimento	tristeza
desenfado	alegria
rebate	medo
esforço	nojo
intensidade	raiva
inação	surpresa
casualidade	tristeza
indulto	alegria
celeuma	medo
usura	nojo
aspereza	raiva
dilema	surpresa
evento	tristeza
indulgência	alegria
repique	medo
arranque	nojo
selvageria	raiva
titubeação	surpresa
ocorrência	tristeza
perdão	alegria
austeridade	medo
arranco	nojo
inflamação	raiva
titubeio	surpresa
acarretar	tristeza
absolvição	alegria
incomplacência	medo
arfagem	nojo
irritabilidade	raiva
enleio	surpresa
causar	tristeza
vênia	alegria
intransigência	medo
cirro	nojo
iracúndia	raiva
anarquia	surpresa
ocasionar	tristeza
clemência	alegria
exigência	medo
paroxismo	nojo
irascibilidade	raiva
cambulhada	surpresa
originar	tristeza
lamentação	alegria
inclemência	medo
piada	nojo
cerceamento	raiva
desalinho	surpresa
provocar	tristeza
justificação	alegria
incompreensão	medo
pieira	nojo
coação	raiva
desarrumação	surpresa
desaire	tristeza
pretexto	alegria
inflexibilidade	medo
rouquidão	nojo
coerção	raiva
desorganização	surpresa
drama	tristeza
evasiva	alegria
rigidez	medo
termo	nojo
coibição	raiva
pandemônio	surpresa
indigência	tristeza
rodeios	alegria
sectarismo	medo
náuseas	nojo
imposição	raiva
baderna	surpresa
inópia	tristeza
subterfúgio	alegria
severidade	medo
treco	nojo
tirania	raiva
barafunda	surpresa
paupérie	tristeza
escusação	alegria
perseguição	medo
disforia	nojo
vaga	raiva
baralhada	surpresa
desvalimento	tristeza
rodeio	alegria
crueza	medo
andaço	nojo
cacho	raiva
meada	surpresa
troço	tristeza
evasão	alegria
impiedade	medo
fealdade	nojo
ondulação	raiva
mexida	surpresa
coisa	tristeza
escapatória	alegria
truculência	medo
repreensão	nojo
sinuosidade	raiva
miscelânea	surpresa
porcaria	tristeza
tergiversação	alegria
maldade	medo
censura	nojo
ziguezague	raiva
mistifório	surpresa
joça	tristeza
dispensa	alegria
malignidade	medo
admoestação	nojo
afluência	raiva
mistura	surpresa
destino	tristeza
licença	alegria
malvadeza	medo
reprimenda	nojo
afluxo	raiva
misturada	surpresa
fado	tristeza
desobrigação	alegria
perversidade	medo
contrário	nojo
excesso	raiva
mixórdia	surpresa
fatalismo	tristeza
liberação	alegria
improbidade	medo
adversário	nojo
exuberância	raiva
salada	surpresa
emergência	tristeza
argumento	alegria
barbárie	medo
desafeiçoado	nojo
fartura	raiva
engano	surpresa
sinistro	tristeza
apologia	alegria
barbaria	medo
inimigo	nojo
jorro	raiva
equívoco	surpresa
urgência	tristeza
alegação	alegria
barbarismo	medo
intrigado	nojo
riqueza	raiva
obscuridade	surpresa
raio	tristeza
autoridade	alegria
ruindade	medo
descontente	nojo
torrente	raiva
zoada	surpresa
estrela	tristeza
causa	alegria
inumanidade	medo
embirra	nojo
barato	raiva
arruaça	surpresa
sina	tristeza
defesa	alegria
irredutibilidade	medo
teima	nojo
curtição	raiva
assuada	surpresa
descalabro	tristeza
fundamento	alegria
acerbidade	medo
insistência	nojo
fingimento	raiva
babel	surpresa
desfortuna	tristeza
motivação	alegria
insensibilidade	medo
reincidência	nojo
dissimulação	raiva
bafafá	surpresa
antropofobia	tristeza
porquê	alegria
impassibilidade	medo
rivalidade	nojo
falsidade	raiva
barulheira	surpresa
insociabilidade	tristeza
título	alegria
sangue-frio	medo
provocação	nojo
artifício	raiva
bulha	surpresa
isolamento	tristeza
móbil	alegria
anomalia	medo
guerra	nojo
artimanha	raiva
chinfrim	surpresa
afastamento	tristeza
móvel	alegria
aleijão	medo
altercação	nojo
enganação	raiva
discórdia	surpresa
reclusão	tristeza
escopo	alegria
cacogênese	medo
contenda	nojo
engodo	raiva
gritaria	surpresa
abortamento	tristeza
fim	alegria
enormidade	medo
disputa	nojo
estratagema	raiva
pancadaria	surpresa
desmancho	tristeza
finalidade	alegria
teratismo	medo
desinteligência	nojo
complicação	raiva
pega	surpresa
amblose	tristeza
meta	alegria
disparate	medo
divisão	nojo
embrulhada	raiva
quebra-pau	surpresa
móvito	tristeza
ânimo	alegria
absurdo	medo
separação	nojo
rebuliço	raiva
quiproquó	surpresa
fiasco	tristeza
mola	alegria
desatino	medo
primazia	nojo
poder	raiva
rolo	surpresa
deformação	tristeza
impulsor	alegria
heresia	medo
cizânia	nojo
mutação	raiva
vozearia	surpresa
anormalidade	tristeza
motor	alegria
contrassenso	medo
dissensão	nojo
variação	raiva
inibição	surpresa
aberração	tristeza
movente	alegria
sevícia	medo
dissenso	nojo
adulteração	raiva
zaragata	surpresa
monstrengo	tristeza
propulsor	alegria
canibalismo	medo
desamizade	nojo
falsificação	raiva
escarcéu	surpresa
inadequadamente	tristeza
causador	alegria
animal	medo
execrar	nojo
contrafação	raiva
rumor	surpresa
ilegalmente	tristeza
determinador	alegria
sangue	medo
abominar	nojo
corrupção	raiva
ruído	surpresa
desarmoniosamente	tristeza
determinante	alegria
indignidade	medo
detestar	nojo
apodrecimento	raiva
zoeira	surpresa
erradamente	tristeza
motivador	alegria
malícia	medo
embirrar	nojo
decomposição	raiva
polvorosa	surpresa
defeituosamente	tristeza
originador	alegria
inconsciência	medo
odiar	nojo
degeneração	raiva
espalhafato	surpresa
incorretamente	tristeza
provocador	alegria
iniquidade	medo
descomedimento	nojo
deterioração	raiva
deus nos acuda	surpresa
irregularmente	tristeza
assunto	alegria
maus-tratos	medo
exagero	nojo
subversão	raiva
turbilhão	surpresa
de leve	tristeza
tema	alegria
animalidade	medo
imoderação	nojo
arranca-rabo	raiva
precipitação	surpresa
deficientemente	tristeza
por esse motivo	alegria
estupidez	medo
agravo	nojo
banzé	raiva
azáfama	surpresa
imperfeitamente	tristeza
inteligência	alegria
transgressão	medo
arrogância	nojo
bate-boca	raiva
prontidão	surpresa
incompletamente	tristeza
intelecto	alegria
infração	medo
atrevimento	nojo
maçada	raiva
açodamento	surpresa
insatisfatoriamente	tristeza
raciocínio	alegria
violação	medo
cinismo	nojo
estopada	raiva
insurreição	surpresa
insuficientemente	tristeza
intelecção	alegria
delito	medo
desaforo	nojo
doidice	raiva
insubordinação	surpresa
pouco	tristeza
intelectualidade	alegria
tropeço	medo
desavergonhamento	nojo
doideira	raiva
amotinação	surpresa
rapidamente	tristeza
sapiência	alegria
deslize	medo
descaramento	nojo
maluquice	raiva
sublevação	surpresa
a custo	tristeza
mente	alegria
criminalidade	medo
desfaçatez	nojo
insanidade	raiva
sedição	surpresa
apenas	tristeza
cabeça	alegria
delinquência	medo
desplante	nojo
demência	raiva
alvoroto	surpresa
com dificuldade	tristeza
gênio	alegria
incoerência	medo
injúria	nojo
alienação	raiva
cio	surpresa
desfavoravelmente	tristeza
capacidade	alegria
despautério	medo
insolência	nojo
insânia	raiva
estro	surpresa
dificilmente	tristeza
mentalidade	alegria
despropósito	medo
petulância	nojo
insensatez	raiva
transporte	surpresa
dificultosamente	tristeza
esperteza	alegria
ilogismo	medo
sem-vergonhice	nojo
imprudência	raiva
suspensão	surpresa
negativamente	tristeza
sagacidade	alegria
irracionalidade	medo
sem-vergonhismo	nojo
inconsequência	raiva
embriaguez	surpresa
penosamente	tristeza
perspicácia	alegria
feioso	medo
ultraje	nojo
irresponsabilidade	raiva
fissura	surpresa
barbaramente	tristeza
argúcia	alegria
criatura	medo
arbitrariedade	nojo
irreflexão	raiva
abrasamento	surpresa
bruscamente	tristeza
agudeza	alegria
ogro	medo
despotismo	nojo
temeridade	raiva
anagogia	surpresa
cruelmente	tristeza
talento	alegria
besta	medo
prepotência	nojo
leviandade	raiva
espasmo	surpresa
desumanamente	tristeza
bom senso	alegria
desumano	medo
defloramento	nojo
excepcionalidade	raiva
gama	surpresa
duramente	tristeza
ponderação	alegria
cruel	medo
desfloração	nojo
idolatria	raiva
incandescência	surpresa
grosseiramente	tristeza
sensatez	alegria
malvado	medo
estupro	nojo
paranoia	raiva
instinto	surpresa
impropriamente	tristeza
lucidez	alegria
desalmado	medo
superstição	nojo
psicose	raiva
rapto	surpresa
inconvenientemente	tristeza
senso	alegria
perverso	medo
crendice	nojo
destempero	raiva
surto	surpresa
indevidamente	tristeza
tino	alegria
bárbaro	medo
abusão	nojo
alor	raiva
voo	surpresa
injustamente	tristeza
circunspecção	alegria
atroz	medo
atormentação	nojo
pulsão	raiva
intuição	surpresa
rudemente	tristeza
equilíbrio	alegria
diabólico	medo
colapso	nojo
rasgo	raiva
palpite	surpresa
severamente	tristeza
prudência	alegria
fera	medo
involução	nojo
instigação	raiva
noção	surpresa
jamais	tristeza
cordura	alegria
carrasco	medo
perecimento	nojo
empurrão	raiva
escurecimento	surpresa
não	tristeza
origem	alegria
celerado	medo
derrocada	nojo
impulsão	raiva
encadeamento	surpresa
nunca	tristeza
fonte	alegria
enorme	medo
descensão	nojo
impulsionamento	raiva
esplendor	surpresa
assim que	tristeza
argumentação	alegria
gigante	medo
afobação	nojo
pulso	raiva
fulgência	surpresa
logo que	tristeza
pressuposto	alegria
gigantesco	medo
demora	nojo
batimento	raiva
magnificiência	surpresa
dano	tristeza
premissa	alegria
colossal	medo
estuo	nojo
arrancada	raiva
bruxaria	surpresa
desvantagem	tristeza
informação	alegria
descomunal	medo
conflagração	nojo
efusão	raiva
mágica	surpresa
inconveniência	tristeza
notícia	alegria
desmedido	medo
revolucionamento	nojo
embalo	raiva
ímã	surpresa
malefício	tristeza
nova	alegria
alimária	medo
revolvimento	nojo
vitalidade	raiva
talismã	surpresa
malfeito	tristeza
novidade	alegria
animalejo	medo
inovação	nojo
tempestade	raiva
condão	surpresa
nocividade	tristeza
porcentagem	alegria
animália	medo
reforma	nojo
temporal	raiva
prestígio	surpresa
perniciosidade	tristeza
percentagem	alegria
asno	medo
renovação	nojo
vendaval	raiva
atrativo	surpresa
mal-entendido	tristeza
proporção	alegria
bichano	medo
giro	nojo
rajada	raiva
sortilégio	surpresa
foi mal	tristeza
relação	alegria
bicho-de-pé	medo
rotação	nojo
chuva	raiva
bruxedo	surpresa
impedimento	tristeza
comparação	alegria
burro	medo
jeriza	nojo
procela	raiva
despacho	surpresa
inversão	tristeza
justiça	alegria
cupim	medo
desfeita	nojo
glorificação	raiva
feitiçaria	surpresa
apocalipse	tristeza
imparcialidade	alegria
inseto	medo
doesto	nojo
louvor	raiva
macumba	surpresa
hecatombe	tristeza
equidade	alegria
piolho	medo
infâmia	nojo
encômio	raiva
mandinga	surpresa
armagedom	tristeza
lei	alegria
térmite	medo
insulto	nojo
engrandecimento	raiva
necromancia	surpresa
epidemia	tristeza
direito	alegria
traça	medo
pirraça	nojo
elogio	raiva
nigromancia	surpresa
açoite	tristeza
em razão de	alegria
verme	medo
vitupério	nojo
consagração	raiva
poção	surpresa
reviravolta	tristeza
em razão	alegria
bruto	medo
vergonheira	nojo
distinção	raiva
trabalho	surpresa
cano	tristeza
elucidação	alegria
cavalo	medo
vexação	nojo
enaltecimento	raiva
beleza	surpresa
reverso	tristeza
aclaramento	alegria
estúpido	medo
dispneia	nojo
frenesim	raiva
formosura	surpresa
avesso	tristeza
aclaração	alegria
grosso	medo
falta de ar	nojo
afervoramento	raiva
graça	surpresa
verso	tristeza
esclarecimento	alegria
mal-educado	medo
moedeira	nojo
fustigação	raiva
arroubamento	surpresa
invés	tristeza
explanação	alegria
corajoso	medo
assalto	nojo
assanho	raiva
enlevação	surpresa
dorso	tristeza
interpretação	alegria
decidido	medo
invectiva	nojo
pertinácia	raiva
acatamento	surpresa
revezamento	tristeza
aula	alegria
desassombrado	medo
investida	nojo
grito	raiva
atendimento	surpresa
apertura	tristeza
aula particular	alegria
amigo	medo
afrontação	nojo
berro	raiva
cumprimento	surpresa
espinho	tristeza
ensino	alegria
camarada	medo
afrontamento	nojo
reclamação	raiva
observação	surpresa
inferno	tristeza
lecionação	alegria
cara	medo
confronto	nojo
protesto	raiva
submissão	surpresa
trato	tristeza
lição	alegria
chapa	medo
gravidade	nojo
lanço	raiva
subordinação	surpresa
penitência	tristeza
desafronta	alegria
fulano	medo
bagagem	nojo
improvisação	raiva
referência	surpresa
véu	tristeza
contrapartida	alegria
ás	medo
carga	nojo
improviso	raiva
aspecto	surpresa
perigo	tristeza
contrapeso	alegria
bom	medo
carregamento	nojo
rasteiro	raiva
perspectiva	surpresa
atenazamento	tristeza
equivalência	alegria
especialista	medo
carrego	nojo
rastejante	raiva
ângulo	surpresa
dolência	tristeza
equiparação	alegria
exímio	medo
fardo	nojo
reptante	raiva
lado	surpresa
flagelação	tristeza
correspondência	alegria
experto	medo
frete	nojo
sextilha	raiva
ponto de vista	surpresa
cilício	tristeza
igualdade	alegria
perito	medo
volume	nojo
de repente	raiva
prisma	surpresa
cruz	tristeza
paridade	alegria
bonificação	medo
ascendência	nojo
altivez	raiva
homenagens	surpresa
espinha	tristeza
agradecimento	alegria
aprendiz	medo
crédito	nojo
arrogante	raiva
recomendações	surpresa
pesadelo	tristeza
preço	alegria
calouro	medo
importância	nojo
orgulhoso	raiva
saudações	surpresa
sobrecarga	tristeza
torna	alegria
estudante	medo
influência	nojo
altivo	raiva
a respeito de	surpresa
traspasso	tristeza
troca	alegria
iniciante	medo
mérito	nojo
rompente	raiva
a respeito	surpresa
mesquinharia	tristeza
vantagem	alegria
novato	medo
valor	nojo
afinco	raiva
no que diz respeito	surpresa
vileza	tristeza
benefício	alegria
primeiranista	medo
culpa	nojo
instância	raiva
diz respeito	surpresa
sordidez	tristeza
lucro	alegria
principiante	medo
compromisso	nojo
tenacidade	raiva
dizer respeito a	surpresa
insignificância	tristeza
ganho	alegria
bicho do mato	medo
dever	nojo
fogo	raiva
no que diz respeito a	surpresa
pequenez	tristeza
em compensação	alegria
insociável	medo
encargo	nojo
intensão	raiva
conta	surpresa
avareza	tristeza
retorno	alegria
misantropo	medo
incumbência	nojo
firmeza	raiva
valimento	surpresa
sovinice	tristeza
reposição	alegria
solitário	medo
obrigação	nojo
eloquência	raiva
estimação	surpresa
escassez	tristeza
entrega	alegria
bicho-de-galinha	medo
ônus	nojo
oratória	raiva
avaliação	surpresa
vilania	tristeza
recondução	alegria
belzebu	medo
responsabilidade	nojo
loquacidade	raiva
apreciação	surpresa
agarramento	tristeza
reversão	alegria
anjo mau	medo
halter	nojo
magniloquência	raiva
meditação	surpresa
estreiteza	tristeza
seguro	alegria
tinhoso	medo
haltere	nojo
altiloquência	raiva
cálculo	surpresa
miudeza	tristeza
recuperação	alegria
lúcifer	medo
tonteira	nojo
facundidade	raiva
exame	surpresa
poupança	tristeza
estipêndio	alegria
canhoto	medo
delíquio	nojo
facúndia	raiva
reflexão	surpresa
somiticaria	tristeza
honorário	alegria
cão	medo
aturdimento	nojo
esganação	raiva
alegações	surpresa
pão-durismo	tristeza
ordenado	alegria
chifrudo	medo
zonzeira	nojo
intemperança	raiva
argumentos	surpresa
tacanhice	tristeza
salário	alegria
cornudo	medo
arrufo	nojo
destemperança	raiva
arrazoados	surpresa
empecilho	tristeza
jornal	alegria
demônio	medo
vácuo	nojo
gula	raiva
considerandos	surpresa
trabuzana	tristeza
jorna	alegria
mafarrico	medo
enfadamento	nojo
glutonaria	raiva
ideias	surpresa
alagamento	tristeza
vencimento	alegria
maldito	medo
seca	nojo
alarvaria	raiva
motivos	surpresa
inundação	tristeza
rendimento	alegria
maligno	medo
decisão	nojo
edacidade	raiva
razões	surpresa
nevasca	tristeza
solução	alegria
satã	medo
confiança	nojo
ereção	raiva
reflexões	surpresa
tufão	tristeza
féria	alegria
satanás	medo
fortaleza	nojo
rijeza	raiva
tendo em consideração	surpresa
penalidade	tristeza
pago	alegria
serpente	medo
moral	nojo
tesura	raiva
culto	surpresa
sentença	tristeza
provento	alegria
tendeiro	medo
constância	nojo
endurecimento	raiva
homenagem	surpresa
corretivo	tristeza
recebimento	alegria
tentador	medo
perseverança	nojo
enrijecimento	raiva
cegueira	surpresa
emenda	tristeza
explica	alegria
agitado	medo
persistência	nojo
esticamento	raiva
preito	surpresa
exemplo	tristeza
desempenha	alegria
diabrete	medo
reação	nojo
estiramento	raiva
religião	surpresa
coima	tristeza
contribui	alegria
irrequieto	medo
rechaço	nojo
retesamento	raiva
altar	surpresa
escarmento	tristeza
corresponde	alegria
levado	medo
renitência	nojo
potência	raiva
afeto	surpresa
vindita	tristeza
diária	alegria
traquina	medo
bloqueio	nojo
robustez	raiva
chamego	surpresa
látego	tristeza
embolso	alegria
travesso	medo
barreira	nojo
destemor	raiva
fidelidade	surpresa
bronca	tristeza
emolumento	alegria
arguto	medo
desaceitação	nojo
centelha	raiva
latria	surpresa
advertência	tristeza
honorários	alegria
astucioso	medo
resistor	nojo
iluminação	raiva
bem-querer	surpresa
chamada	tristeza
soldada	alegria
astuto	medo
atrito	nojo
imaginação	raiva
querença	surpresa
ensinadela	tristeza
soldo	alegria
esperto	medo
fricção	nojo
inspiração	raiva
benquerença	surpresa
sermão	tristeza
comissão	alegria
inteligente	medo
defensão	nojo
lampejo	raiva
dileção	surpresa
carraspana	tristeza
abono	alegria
perspicaz	medo
contradição	nojo
sopro	raiva
carinho	surpresa
descompostura	tristeza
cota	alegria
sagaz	medo
contraposição	nojo
veio	raiva
ternura	surpresa
sabão	tristeza
parcela	alegria
bodega	medo
contradita	nojo
pluma	raiva
amizade	surpresa
sarabanda	tristeza
prestação	alegria
diacho	medo
desmentido	nojo
penacho	raiva
meiguice	surpresa
cautério	tristeza
quota	alegria
caramba	medo
desigualdade	nojo
multa	raiva
ligação	surpresa
importunação	tristeza
recompensação	alegria
cáspite	medo
disparidade	nojo
cálamo	raiva
dilecção	surpresa
espalhanço	tristeza
purgação	alegria
estafermo	medo
discrepância	nojo
escrita	raiva
merecimento	surpresa
surra	tristeza
desforra	alegria
garganta	medo
dissemelhança	nojo
escritor	raiva
valia	surpresa
sova	tristeza
despique	alegria
cânion	medo
contraste	nojo
autor	raiva
concentração	surpresa
espancamento	tristeza
forra	alegria
peça	medo
assimetria	nojo
ter pena de	raiva
asceticismo	surpresa
pau	tristeza
retaliação	alegria
bofe	medo
antinomia	nojo
sacrifício	raiva
ascetismo	surpresa
bordoada	tristeza
revanche	alegria
centopeia	medo
desacordo	nojo
represália	raiva
mística	surpresa
esfrega	tristeza
revide	alegria
dragão	medo
discordância	nojo
troco	raiva
misticismo	surpresa
trepa	tristeza
restauração	alegria
morteiro	medo
incongruência	nojo
saldo	raiva
contemporização	surpresa
tosa	tristeza
reabilitação	alegria
benzedeira	medo
contraditória	nojo
desforço	raiva
subserviência	surpresa
tosquiadela	tristeza
repetição	alegria
necromante	medo
réplica	nojo
desgoverno	raiva
sujeição	surpresa
tareia	tristeza
reintegração	alegria
adivinha	medo
atravanco	nojo
desregramento	raiva
humildade	surpresa
escovadela	tristeza
estorno	alegria
feiticeira	medo
empeço	nojo
agravamento	raiva
estimativa	surpresa
malha	tristeza
espórtula	alegria
maga	medo
encalhe	nojo
pique	raiva
aferição	surpresa
malhação	tristeza
molhadura	alegria
nigromante	medo
inconveniente	nojo
roda-viva	raiva
aproximação	surpresa
regresso	tristeza
subsídio	alegria
vidente	medo
obstrução	nojo
burburinho	raiva
afinidade	surpresa
retornamento	tristeza
alvíssaras	alegria
megera	medo
pespego	nojo
fervedouro	raiva
confraternidade	surpresa
retornança	tristeza
redenção	alegria
seresma	medo
tranca	nojo
abanamento	raiva
empatia	surpresa
revinda	tristeza
relevação	alegria
borboleta	medo
travanca	nojo
abanadura	raiva
fraternidade	surpresa
tornada	tristeza
relevamento	alegria
mariposa	medo
manifestação	nojo
agitamento	raiva
identidade	surpresa
vinda	tristeza
Catarse	alegria
panapaná	medo
motinação	nojo
comício	raiva
solidariedade	surpresa
circunferência	tristeza
jubileu	alegria
bolsa	medo
alarido	nojo
enforcamento	raiva
pessoa agradável	surpresa
borda	tristeza
reparo	alegria
mala	medo
desobediência	nojo
cadafalso	raiva
prática	surpresa
circuito	tristeza
conserto	alegria
saco	medo
insubmissão	nojo
patíbulo	raiva
ritual	surpresa
circulação	tristeza
arranjo	alegria
meretriz	medo
rebeldia	nojo
guilhotina	raiva
sombração	surpresa
círculo	tristeza
restauro	alegria
prostituta	medo
impasse	nojo
ardil	raiva
espectro	surpresa
contorno	tristeza
remendo	alegria
vaca	medo
sinuca	nojo
armadilha	raiva
duende	surpresa
pirueta	tristeza
ajuste	alegria
cantada	medo
privação	nojo
cilada	raiva
espetro	surpresa
redor	tristeza
melhoria	alegria
galanteio	medo
custo	nojo
emboscada	raiva
visagem	surpresa
roda	tristeza
obra	alegria
conversa	medo
suor	nojo
laço	raiva
espírito	surpresa
rodada	tristeza
abjuração	alegria
papo	medo
complexidade	nojo
ancinho	raiva
sombra	surpresa
rodopio	tristeza
apostasia	alegria
lábia	medo
complexidão	nojo
forquilha	raiva
anhangá	surpresa
translação	tristeza
recuo	alegria
patifaria	medo
enredamento	nojo
garfo	raiva
coco	surpresa
passeio	tristeza
céu	alegria
canalhice	medo
obscenidade	nojo
forcado	raiva
marmota	surpresa
girata	tristeza
paraíso	alegria
safadeza	medo
indecência	nojo
forqueta	raiva
vista	surpresa
virada	tristeza
boa sorte	alegria
sacanagem	medo
desonestidade	nojo
botequim	raiva
olhar	surpresa
viradela	tristeza
risco	alegria
velhacaria	medo
desvergonha	nojo
vendinha de roça	raiva
olho	surpresa
viragem	tristeza
chance	alegria
velhacagem	medo
imoralidade	nojo
brabeza	raiva
visiva	surpresa
espira	tristeza
bafejo	alegria
velhacada	medo
abjeção	nojo
bravosidade	raiva
ilusão	surpresa
espiral	tristeza
futuro	alegria
trapaça	medo
turpitude	nojo
chicote	raiva
cenário	surpresa
rosca	tristeza
fadário	alegria
ninharia	medo
desacolhimento	nojo
azorrague	raiva
imagem	surpresa
volteio	tristeza
sestro	alegria
mixaria	medo
negativa	nojo
vergalho	raiva
paisagem	surpresa
curva	tristeza
mera	alegria
futilidade	medo
fora	nojo
vergasta	raiva
panorama	surpresa
meandro	tristeza
cadeia	alegria
frivolidade	medo
abstenção	nojo
peste	raiva
concepção	surpresa
serpeio	tristeza
presídio	alegria
ridicularia	medo
reprovação	nojo
relho	raiva
previsão	surpresa
tortuosidade	tristeza
penitenciária	alegria
migalhice	medo
desaprovação	nojo
pandemia	raiva
revelação	surpresa
guinada	tristeza
xilindró	alegria
zé-ninguém	medo
desabono	nojo
maldoso	raiva
visom	surpresa
viravolta	tristeza
cárcere	alegria
pé-rapado	medo
veto	nojo
maléfico	raiva
vison	surpresa
volta-face	tristeza
xadrez	alegria
insignificante	medo
repudiação	nojo
malévolo	raiva
ficção	surpresa
desar	tristeza
referida	alegria
joão-ninguém	medo
evitação	nojo
vil	raiva
invenção	surpresa
replicação	tristeza
expressa	alegria
borra-botas	medo
preterição	nojo
insensível	raiva
quimera	surpresa
resposta	tristeza
exposta	alegria
pobre-diabo	medo
ostracismo	nojo
impiedoso	raiva
utopia	surpresa
vindicta	tristeza
manda	alegria
homúnculo	medo
desamparo	nojo
inclemente	raiva
abantesma	surpresa
laçada	tristeza
determina	alegria
calhambeque	medo
desabrigo	nojo
duro	raiva
avantesma	surpresa
por volta de	tristeza
impõe	alegria
cacareco	medo
desarrimo	nojo
feroz	raiva
avejão	surpresa
lamúria	tristeza
estabelece	alegria
bugiganga	medo
cena	nojo
odioso	raiva
fantasmagoria	surpresa
choro	tristeza
denominada	alegria
caco	medo
esparramo	nojo
malevolente	raiva
fictício	surpresa
lamento	tristeza
herança	alegria
tralha	medo
querela	nojo
molesto	raiva
inventado	surpresa
queixume	tristeza
fazenda	alegria
tareco	medo
estardalhaço	nojo
pravo	raiva
simulado	surpresa
percussão	tristeza
bens	alegria
traste	medo
excreção	nojo
defeituoso	raiva
irreal	surpresa
murro	tristeza
posses	alegria
negócio	medo
ejeção	nojo
mal-acabado	raiva
fingido	surpresa
soco	tristeza
recursos	alegria
trem	medo
evacuação	nojo
ruim	raiva
aparente	surpresa
sopapo	tristeza
acervo	alegria
parada	medo
proscrição	nojo
imperfeito	raiva
suposto	surpresa
pisadura	tristeza
algo	alegria
pertences	medo
eliminação	nojo
desprimoroso	raiva
simulacro	surpresa
equimose	tristeza
liga	alegria
coisas	medo
exclusão	nojo
inferior	raiva
esqueleto	surpresa
ferida	tristeza
fábula	alegria
objetos	medo
expurgação	nojo
medíocre	raiva
magrelo	surpresa
ferimento	tristeza
aventura	alegria
maconha	medo
secreção	nojo
ordinário	raiva
magricela	surpresa
hematoma	tristeza
meio	alegria
baseado	medo
emissão	nojo
péssimo	raiva
fato	surpresa
lesão	tristeza
posse	alegria
haxixe	medo
expiração	nojo
reles	raiva
caso	surpresa
pisadela	tristeza
condição	alegria
marijuana	medo
segregação	nojo
irregular	raiva
ocorrido	surpresa
traumatismo	tristeza
natural	alegria
erva	medo
freio	nojo
velho	raiva
sucedido	surpresa
talho	tristeza
dinheiro	alegria
liamba	medo
proibição	nojo
estragado	raiva
feito	surpresa
corte	tristeza
tesouro	alegria
semente	medo
comedimento	nojo
horrível	raiva
sábio	surpresa
incisão	tristeza
haver	alegria
caroço	medo
contenção	nojo
atamancado	raiva
erudito	surpresa
chofre	tristeza
vento	alegria
cascavel	medo
interrupção	nojo
mal-amanhado	raiva
crânio	surpresa
truque	tristeza
chorume	alegria
víbora	medo
represa	nojo
mal-ajambrado	raiva
sintoma	surpresa
trama	tristeza
meios	alegria
estômago	medo
recalcamento	nojo
prejudicial	raiva
presença	surpresa
desfalque	tristeza
nota	alegria
abdome	medo
castigador	nojo
desvantajoso	raiva
chegada	surpresa
rombo	tristeza
ouro	alegria
abdômen	medo
punidor	nojo
infeliz	raiva
apresentação	surpresa
roubo	tristeza
patrimônio	alegria
bandulho	medo
repressor	nojo
triste	raiva
exibição	surpresa
putsch	tristeza
cacife	alegria
barriga	medo
sentenciador	nojo
trágico	raiva
exposição	surpresa
corrente	tristeza
conquista	alegria
bojo	medo
descarte	nojo
catastrófico	raiva
sessão	surpresa
lufada	tristeza
troféu	alegria
pança	medo
despojo	nojo
danoso	raiva
mostra	surpresa
bicada	tristeza
brilharete	alegria
panturra	medo
refugo	nojo
desastroso	raiva
demonstração	surpresa
golada	tristeza
brilhantura	alegria
ventre	medo
despojamento	nojo
fatal	raiva
princípio	surpresa
gole	tristeza
peripécia	alegria
desabrimento	medo
descuramento	nojo
grave	raiva
início	surpresa
goleta	tristeza
acontecido	alegria
rudeza	medo
esquecimento	nojo
terrível	raiva
começo	surpresa
golo	tristeza
resultado	alegria
mecha	medo
descuido	nojo
funesto	raiva
nascimento	surpresa
hausto	tristeza
desfecho	alegria
agredir	medo
desproteção	nojo
nefasto	raiva
advento	surpresa
pinga	tristeza
conclusão	alegria
bico	medo
renunciação	nojo
nocivo	raiva
descoberta	surpresa
sorvo	tristeza
desenlace	alegria
entrave	medo
distanciamento	nojo
lesivo	raiva
assombramento	surpresa
tragada	tristeza
decorrência	alegria
xeque	medo
controvérsia	nojo
pernicioso	raiva
encenação	surpresa
trago	tristeza
fruto	alegria
bolada	medo
debate	nojo
calamitoso	raiva
função	surpresa
aniquilação	tristeza
repercussão	alegria
dinheirame	medo
demanda	nojo
infausto	raiva
montagem	surpresa
detrimento	tristeza
efeito	alegria
desproporção	medo
litígio	nojo
infesto	raiva
número	surpresa
dispersão	tristeza
resulta	alegria
festival	medo
polêmica	nojo
malfazejo	raiva
representação	surpresa
destroço	tristeza
resultância	alegria
fluxo	medo
porfia	nojo
miserável	raiva
show	surpresa
desbaratamento	tristeza
corolário	alegria
demasia	medo
arrenegar	nojo
lamentável	raiva
quadro	surpresa
desbarato	tristeza
coroamento	alegria
enchente	medo
indeferir	nojo
desastrado	raiva
quietação	surpresa
destituição	tristeza
parto	alegria
grupo	medo
negar	nojo
ruinoso	raiva
ramerrão	surpresa
deposição	tristeza
parição	alegria
pleonasmo	medo
recusar	nojo
ominoso	raiva
serenidade	surpresa
desbaste	tristeza
acabamento	alegria
quantia	medo
dissentimento	nojo
nocente	raiva
passado	surpresa
caminho	tristeza
consequência	alegria
excrescência	medo
desencontro	nojo
indelicado	raiva
maravilhado	surpresa
percurso	tristeza
produto	alegria
feixe	medo
inconsonância	nojo
desagradável	raiva
siderado	surpresa
itinerário	tristeza
apoteose	alegria
multidão	medo
cisão	nojo
descortês	raiva
aturdido	surpresa
rota	tristeza
capitólio	alegria
redundância	medo
diversidade	nojo
intratável	raiva
estarrecido	surpresa
direção	tristeza
aclamação	alegria
superabundância	medo
distância	nojo
rude	raiva
assombrado	surpresa
rumo	tristeza
aplauso	alegria
coleção	medo
apartamento	nojo
ríspido	raiva
abismado	surpresa
viagem	tristeza
ovação	alegria
data	medo
apartação	nojo
áspero	raiva
banzado	surpresa
roteiro	tristeza
saudação	alegria
mar	medo
distanciação	nojo
insuportável	raiva
entorpecido	surpresa
trajetória	tristeza
superioridade	alegria
oceano	medo
inaptidão	nojo
intolerável	raiva
adormecido	surpresa
órbita	tristeza
hegemonia	alegria
caminhão	medo
incapacidade	nojo
detestável	raiva
dormente	surpresa
coincidência	tristeza
predominância	alegria
aglomeração	medo
negra	nojo
abominável	raiva
suspenso	surpresa
contingência	tristeza
preponderância	alegria
alude	medo
impede	nojo
abominoso	raiva
bestificado	surpresa
achado	tristeza
predomínio	alegria
avalancha	medo
insta	nojo
irritado	raiva
escancarado	surpresa
tipo	tristeza
prevalência	alegria
avalanche	medo
desconhece	nojo
irritadiço	raiva
estacado	surpresa
gênero	tristeza
supremacia	alegria
bloco	medo
burla	nojo
aborrecível	raiva
gelado	surpresa
categoria	tristeza
império	alegria
camada	medo
chamariz	nojo
incompetente	raiva
gélido	surpresa
qualidade	tristeza
suntuosidade	alegria
desperdício	medo
drible	nojo
incapaz	raiva
extasiado	surpresa
classe	tristeza
fausto	alegria
penca	medo
finta	nojo
desqualificado	raiva
assarapantado	surpresa
variedade	tristeza
imponência	alegria
magote	medo
fosquinha	nojo
inábil	raiva
babado	surpresa
família	tristeza
enfeite	alegria
montanha	medo
isca	nojo
imprestável	raiva
embaçado	surpresa
laia	tristeza
ornamento	alegria
cabedal	medo
logro	nojo
ineficiente	raiva
inexpressivo	surpresa
proveito	tristeza
adorno	alegria
caterva	medo
chama	nojo
ineficaz	raiva
interdito	surpresa
posição	tristeza
ornato	alegria
caudal	medo
indeferimento	nojo
inepto	raiva
obstúpido	surpresa
nível	tristeza
palma	alegria
infinidade	medo
ausência	nojo
limitado	raiva
petrificado	surpresa
parte	tristeza
vencida	alegria
porrada	medo
carência	nojo
improdutivo	raiva
abalado	surpresa
quinhão	tristeza
brilhareto	alegria
dúzia	medo
incompetência	nojo
parado	raiva
encantado	surpresa
pedaço	tristeza
certeza	alegria
estrupício	medo
imperícia	nojo
falho	raiva
impressionado	surpresa
final	tristeza
acertamento	alegria
imensidão	medo
inépcia	nojo
falto	raiva
extático	surpresa
término	tristeza
atino	alegria
resma	medo
prego	nojo
deficiente	raiva
varado	surpresa
remate	tristeza
exatidão	alegria
serra	medo
estafamento	nojo
escasso	raiva
estremecido	surpresa
panela	tristeza
justeza	alegria
lixeira	medo
ancilostomíase	nojo
pobre	raiva
apreciado	surpresa
escuro	tristeza
acordo	alegria
pilha	medo
ancilostomose	nojo
impróprio	raiva
estimado	surpresa
negridão	tristeza
adaptação	alegria
acúmulo	medo
amarelão	nojo
inapropriado	raiva
valorizado	surpresa
negror	tristeza
ajustado	alegria
floresta	medo
opilação	nojo
inadequado	raiva
respeitado	surpresa
negro	tristeza
ajustamento	alegria
ajuntamento	medo
anasarca	nojo
despropositado	raiva
prezado	surpresa
escuridade	tristeza
combinação	alegria
cordilheira	medo
labuta	nojo
inoportuno	raiva
considerado	surpresa
trevas	tristeza
conchavo	alegria
serrania	medo
lida	nojo
indevido	raiva
conceituado	surpresa
pretidão	tristeza
contrato	alegria
cabeço	medo
abafação	nojo
descabido	raiva
benquisto	surpresa
pretume	tristeza
convenção	alegria
colina	medo
pregação	nojo
disparatado	raiva
querido	surpresa
pretura	tristeza
cabimento	alegria
cômoro	medo
tráfego	nojo
incorreto	raiva
adorado	surpresa
manto	tristeza
adequação	alegria
montículo	medo
maratona	nojo
errado	raiva
amado	surpresa
névoa	tristeza
sabedoria	alegria
morro	medo
trabalheira	nojo
desacertado	raiva
popular	surpresa
cerração	tristeza
oportunidade	alegria
outeiro	medo
faina	nojo
impreciso	raiva
dileto	surpresa
neblina	tristeza
propriedade	alegria
proeminência	medo
lide	nojo
inexato	raiva
valido	surpresa
nevoeiro	tristeza
regulação	alegria
acumulação	medo
labor	nojo
deselegante	raiva
chocado	surpresa
carranca	tristeza
regulagem	alegria
reunião	medo
lavor	nojo
desobediente	raiva
atordoado	surpresa
cenho	tristeza
renome	alegria
monturo	medo
afazer	nojo
inquieto	raiva
desconcertado	surpresa
sobrecenho	tristeza
fama	alegria
alto	medo
lesco-lesco	nojo
endiabrado	raiva
atrapalhado	surpresa
tromba	tristeza
celebridade	alegria
selva	medo
lufa-lufa	nojo
indisciplinado	raiva
confundido	surpresa
estica	tristeza
imortalidade	alegria
frota	medo
asfixia	nojo
rebelde	raiva
sarapantado	surpresa
mendicância	tristeza
lustre	alegria
coluna	medo
estrangulamento	nojo
indócil	raiva
assaltado	surpresa
mendicidade	tristeza
notabilidade	alegria
contingente	medo
abafamento	nojo
birrento	raiva
deslumbrado	surpresa
míngua	tristeza
notoriedade	alegria
cúmulo	medo
asma	nojo
teimoso	raiva
fascinado	surpresa
pauperismo	tristeza
reconhecimento	alegria
elevação	medo
afogo	nojo
insubmisso	raiva
cativado	surpresa
rafa	tristeza
reputação	alegria
partilha	medo
afogamento	nojo
inconformado	raiva
embevecido	surpresa
subdesenvolvimento	tristeza
brasão	alegria
saraiva	medo
abastamento	nojo
turrão	raiva
arrebatado	surpresa
últimas	tristeza
grandiosidade	alegria
amontoamento	medo
repleção	nojo
difícil	raiva
seduzido	surpresa
bagatela	tristeza
louro	alegria
cardume	medo
saturação	nojo
árduo	raiva
enleado	surpresa
mesquinheza	tristeza
magnificência	alegria
enxame	medo
omissão	nojo
penoso	raiva
assustado	surpresa
sovinaria	tristeza
opulência	alegria
pinha	medo
relaxo	nojo
custoso	raiva
sobressaltado	surpresa
tacanharia	tristeza
sumptuosidade	alegria
ruma	medo
insipidez	nojo
trabalhoso	raiva
alarmado	surpresa
tacanhez	tristeza
auréola	alegria
braçadeira	medo
sensaboria	nojo
laborioso	raiva
apavorado	surpresa
tacanheza	tristeza
halo	alegria
murundu	medo
uniformidade	nojo
espinhoso	raiva
aterrado	surpresa
lazeira	tristeza
resplendor	alegria
imposta	medo
invariabilidade	nojo
imoral	raiva
aterrorizado	surpresa
lama	tristeza
jogo da glória	alegria
ror	medo
inalterabilidade	nojo
indecente	raiva
atemorizado	surpresa
vivência	tristeza
oca	alegria
dilúvio	medo
mesmice	nojo
indecoroso	raiva
amedrontado	surpresa
envolvimento	tristeza
grandeza	alegria
fuzilaria	medo
rotina	nojo
condenável	raiva
intimidado	surpresa
convicção	tristeza
felicitação	alegria
meda	medo
imobilidade	nojo
impudico	raiva
perturbado	surpresa
faro	tristeza
parabém	alegria
montoeira	medo
unissonância	nojo
pecaminoso	raiva
esgazeado	surpresa
bacorejo	tristeza
parabéns	alegria
dose	medo
beberagem	nojo
demo	raiva
espaventado	surpresa
presságio	tristeza
prolfaça	alegria
fração	medo
eletuário	nojo
capeta	raiva
chamativo	surpresa
sentido	tristeza
embora	alegria
massa	medo
elixir	nojo
mau-caráter	raiva
garrido	surpresa
consciência	tristeza
cortesias	alegria
cópia	medo
loque	nojo
jura	raiva
espalhafatoso	surpresa
ideia	tristeza
mesuras	alegria
agrupamento	medo
medicamento	nojo
pinima	raiva
colorido	surpresa
conceito	tristeza
salamaleques	alegria
prodigalidade	medo
purgante	nojo
contágio	raiva
vivo	surpresa
qualidades	tristeza
recomendação	alegria
turba	medo
tisana	nojo
blasfêmia	raiva
vívido	surpresa
caráter	tristeza
visita	alegria
tanto	medo
xaropada	nojo
esconjuro	raiva
intenso	surpresa
índole	tristeza
agachados	alegria
aluvião	medo
calda	nojo
tição	raiva
berrante	surpresa
natureza	tristeza
aplicações	alegria
suma	medo
aborrecido	nojo
nervosidade	raiva
gritante	surpresa
coração	tristeza
brincadeira	alegria
medida	medo
aperreador	nojo
impertinência	raiva
indeciso	surpresa
temperamento	tristeza
brinquedo	alegria
total	medo
aperreante	nojo
pressão	raiva
hesitante	surpresa
essência	tristeza
folguedo	alegria
escala	medo
aporrinhante	nojo
estupefaciente	raiva
vacilante	surpresa
feitio	tristeza
aposentadoria	alegria
tamanho	medo
azucrinante	nojo
entorpecente	raiva
atalhado	surpresa
condolências	tristeza
voluptuosidade	alegria
dimensão	medo
cacete	nojo
alucinógeno	raiva
confuso	surpresa
maciez	tristeza
alheação	alegria
extensão	medo
cansativo	nojo
narcótico	raiva
desnorteado	surpresa
macieza	tristeza
abstração	alegria
área	medo
chato	nojo
tóxico	raiva
desorientado	surpresa
maleabilidade	tristeza
abstraimento	alegria
abastança	medo
enfadonho	nojo
excitante	raiva
duvidoso	surpresa
macio	tristeza
divagação	alegria
copiosidade	medo
enfastiante	nojo
estimulante	raiva
incerto	surpresa
lerdeza	tristeza
vagueação	alegria
cheia	medo
enjoado	nojo
fármaco	raiva
indefinido	surpresa
descanso	tristeza
inadvertência	alegria
ravina	medo
entediante	nojo
preparado	raiva
inseguro	surpresa
soneira	tristeza
lapso	alegria
rio	medo
fastidioso	nojo
substância	raiva
irresoluto	surpresa
sono	tristeza
recreio	alegria
lava	medo
impertinente	nojo
ingrediente	raiva
titubeante	surpresa
sonolência	tristeza
lazer	alegria
enxurro	medo
implicante	nojo
adição	raiva
contérrito	surpresa
vagar	tristeza
hobby	alegria
fragmento	medo
importuno	nojo
dependência	raiva
desatinado	surpresa
molícia	tristeza
desunião	alegria
fatia	medo
irritante	nojo
mentira	raiva
tonto	surpresa
fácil	tristeza
chinfra	alegria
partícula	medo
maçador	nojo
inverdade	raiva
transtornado	surpresa
simples	tristeza
desenfadamento	alegria
segmento	medo
maçante	nojo
farsa	raiva
concentrado	surpresa
descomplicado	tristeza
derivação	alegria
bocado	medo
maçudo	nojo
lorota	raiva
pensativo	surpresa
facilidade	tristeza
desencaminhamento	alegria
ração	medo
mortal	nojo
balela	raiva
ensimesmado	surpresa
descomplicação	tristeza
deslocação	alegria
quota-parte	medo
tedioso	nojo
grosseirão	raiva
absorvido	surpresa
acessível	tristeza
digressão	alegria
cota-parte	medo
excomungado	nojo
malcriado	raiva
abstraído	surpresa
canja	tristeza
digresso	alegria
dosagem	medo
amaldiçoado	nojo
ignorante	raiva
alheado	surpresa
sopa	tristeza
troça	alegria
arsenal	medo
excomunhão	nojo
impolido	raiva
distraído	surpresa
transigência	tristeza
farra	alegria
mão-cheia	medo
opróbio	nojo
incivil	raiva
desatento	surpresa
flexibilidade	tristeza
alívio	alegria
mancheia	medo
previdência	nojo
boçal	raiva
desconcentrado	surpresa
conjuntura	tristeza
orgia	alegria
punhado	medo
providência	nojo
selvático	raiva
imerso	surpresa
caipora	tristeza
folgança	alegria
multiplicidade	medo
sobreaviso	nojo
depravado	raiva
ausente	surpresa
pé	tristeza
folia	alegria
pluralidade	medo
premeditação	nojo
pervertido	raiva
distante	surpresa
inhaca	tristeza
cambalhota	alegria
sem-número	medo
preparação	nojo
obsceno	raiva
alienado	surpresa
embezerramento	tristeza
brinco	alegria
esbanjamento	medo
preparativo	nojo
pornográfico	raiva
alheio	surpresa
burrice	tristeza
desporto	alegria
dissipação	medo
preparo	nojo
sórdido	raiva
entregue	surpresa
bílis	tristeza
espairecimento	alegria
dilapidação	medo
cismo	nojo
sem-vergonha	raiva
entretido	surpresa
fubeca	tristeza
esporte	alegria
malbaratamento	medo
antecipação	nojo
vulgar	raiva
hipnotizado	surpresa
fubecada	tristeza
jogo	alegria
encadeação	medo
prolepse	nojo
rústico	raiva
reconcentrado	surpresa
academia	tristeza
programa	alegria
ordem	medo
ardência	nojo
rudimentar	raiva
introvertido	surpresa
cocoroca	tristeza
entretém	alegria
sequência	medo
ardimento	nojo
rugoso	raiva
introverso	surpresa
fraca	tristeza
entretimento	alegria
seriação	medo
brasa	nojo
crespo	raiva
preocupado	surpresa
sarna	tristeza
uso	alegria
sucessão	medo
incêndio	nojo
tosco	raiva
enlevado	surpresa
escabiose	tristeza
usufruto	alegria
soma	medo
tocha	nojo
mal-arranjado	raiva
abasbacado	surpresa
gafeira	tristeza
utilização	alegria
colecção	medo
calmaria	nojo
mal-arrumado	raiva
aparvalhado	surpresa
catinga	tristeza
fruição	alegria
conjunto	medo
labareda	nojo
feio	raiva
estatelado	surpresa
fedor	tristeza
desfrute	alegria
ano	medo
esto	nojo
grosseira	raiva
espavorido	surpresa
sereno	tristeza
usufruição	alegria
seriado	medo
flama	nojo
erupção	raiva
paralisado	surpresa
cheiro	tristeza
aproveitamento	alegria
enfiada	medo
fogueira	nojo
abespinhamento	raiva
alterado	surpresa
vagaroso	tristeza
orgasmo	alegria
firmamento	medo
frágua	nojo
agastadura	raiva
atarantado	surpresa
chuvisco	tristeza
clímax	alegria
cosmos	medo
mormaço	nojo
azedo	raiva
baratinado	surpresa
zimbro	tristeza
bastar	alegria
universo	medo
soalheira	nojo
acidade	raiva
conturbado	surpresa
autodestruição	tristeza
atender	alegria
globo	medo
lirismo	nojo
acidez	raiva
embaraçado	surpresa
autocídio	tristeza
chegar	alegria
planeta	medo
caloria	nojo
acrimônia	raiva
embaralhado	surpresa
autoextermínio	tristeza
alegrar	alegria
hemisfério	medo
quentura	nojo
azedia	raiva
intranquilo	surpresa
autoquíria	tristeza
contentar	alegria
homem	medo
aquecimento	nojo
ranço	raiva
zaranza	surpresa
solidão	tristeza
rejubilar	alegria
raça humana	medo
canícula	nojo
agror	raiva
titã	surpresa
solitude	tristeza
cumprir	alegria
humanidade	medo
calidez	nojo
cerveja	raiva
enlevamento	surpresa
soledade	tristeza
corresponder	alegria
mortais	medo
queimor	nojo
afincamento	raiva
acme	surpresa
insulamento	tristeza
desempenhar	alegria
gênero humano	medo
fervura	nojo
caturrice	raiva
plenitude	surpresa
silêncio	tristeza
executar	alegria
população	medo
religiosidade	nojo
teimosice	raiva
culminância	surpresa
mutismo	tristeza
realizar	alegria
povo	medo
aguça	nojo
turra	raiva
inteireza	surpresa
mudez	tristeza
indenizar	alegria
âmbito	medo
afoiteza	nojo
manha	raiva
totalidade	surpresa
mudeza	tristeza
liquidar	alegria
campo	medo
denodo	nojo
cânhamo	raiva
excelência	surpresa
calada	tristeza
pagar	alegria
domínio	medo
desembaraço	nojo
fricote	raiva
maestria	surpresa
incomunicação	tristeza
quitar	alegria
esfera	medo
impavidez	nojo
acinte	raiva
magistralidade	surpresa
atravancamento	tristeza
retribuir	alegria
terreno	medo
raça	nojo
exasperado	raiva
mestria	surpresa
desconcerto	tristeza
saldar	alegria
bando	medo
heroísmo	nojo
impaciente	raiva
quilate	surpresa
jetatura	tristeza
solver	alegria
mundéu	medo
atitude	nojo
agastado	raiva
sublimidade	surpresa
inconstância	tristeza
empanturrar	alegria
turma	medo
iniciativa	nojo
agastadiço	raiva
virtuosidade	surpresa
instabilidade	tristeza
desforrar-se	alegria
casta	medo
irreverência	nojo
ansioso	raiva
arte	surpresa
variabilidade	tristeza
fartar	alegria
estirpe	medo
façanha	nojo
angustiado	raiva
lindeza	surpresa
volubilidade	tristeza
mitigar	alegria
estofa	medo
proeza	nojo
alvoroçado	raiva
clareza	surpresa
mutabilidade	tristeza
saciar	alegria
linhagem	medo
pujança	nojo
estressado	raiva
garbo	surpresa
flutuação	tristeza
vingar-se	alegria
abstergido	medo
peito	nojo
desequilibrado	raiva
alinho	surpresa
mobilidade	tristeza
esclarecer	alegria
absterso	medo
resolução	nojo
descontrolado	raiva
aprimoramento	surpresa
alternativa	tristeza
convencer	alegria
asseado	medo
desassombro	nojo
aflito	raiva
aperfeiçoamento	surpresa
possibilidade	tristeza
persuadir	alegria
dessujo	medo
galhardia	nojo
rápido	raiva
sofisticação	surpresa
transmutação	tristeza
perfazer	alegria
imaculado	medo
hombridade	nojo
enérgico	raiva
flor	surpresa
bicicleta	tristeza
obedecer	alegria
inconspurcado	medo
braço	nojo
vigoroso	raiva
bondade	surpresa
bike	tristeza
preencher	alegria
lavado	medo
autoestima	nojo
frenético	raiva
generosidade	surpresa
bici	tristeza
respeitar	alegria
limpo	medo
honradez	nojo
sôfrego	raiva
beneficência	surpresa
magrela	tristeza
reparar	alegria
mondo	medo
ufania	nojo
neural	raiva
magnanimidade	surpresa
magrelinha	tristeza
suprir	alegria
polido	medo
entono	nojo
nerval	raiva
atilamento	surpresa
kalanga	tristeza
remediar	alegria
purificado	medo
probidade	nojo
aperreamento	raiva
asseio	surpresa
camelo	tristeza
desagravar	alegria
puro	medo
airosidade	nojo
prurido	raiva
aprumo	surpresa
tangolomango	tristeza
sorrir	alegria
mundão	medo
liberalidade	nojo
cócegas	raiva
afinação	surpresa
ócio	tristeza
condescender	alegria
aglomerado	medo
munificência	nojo
hum	raiva
refinação	surpresa
molejo	tristeza
contemporizar	alegria
amontoação	medo
nobreza	nojo
irresignação	raiva
atoleiro	surpresa
gingado	tristeza
transigir	alegria
conglomerado	medo
branqueação	nojo
barranco	raiva
embrulho	surpresa
ginga	tristeza
permitir	alegria
conglomeração	medo
alvejamento	nojo
busílis	raiva
enrascada	surpresa
malandragem	tristeza
regozijar	alegria
empilhado	medo
branqueamento	nojo
cadeado	raiva
entalação	surpresa
imperturbabilidade	tristeza
deliciar	alegria
sobreposto	medo
cora	nojo
empacho	raiva
entaladela	surpresa
fleuma	tristeza
deleitar	alegria
agrupado	medo
coradouro	nojo
empata	raiva
apurado	surpresa
pachorra	tristeza
divertir	alegria
reunido	medo
indicação	nojo
empeno	raiva
purificação	surpresa
abulia	tristeza
animar	alegria
atulhado	medo
definição	nojo
encravo	raiva
ápice	surpresa
ociosidade	tristeza
encantar	alegria
entulhado	medo
limitação	nojo
encrenca	raiva
corre-corre	surpresa
esfriamento	tristeza
regalar	alegria
apinhado	medo
demarcação	nojo
estorva	raiva
arremate	surpresa
resfriamento	tristeza
distrair	alegria
atravancado	medo
delimitação	nojo
gargalo	raiva
retoque	surpresa
refrigeração	tristeza
entreter	alegria
poupado	medo
deliberação	nojo
imbondo	raiva
retidão	surpresa
mediocridade	tristeza
enlevar	alegria
amealhado	medo
mandado	nojo
intercepção	raiva
acribia	surpresa
precariedade	tristeza
letificar	alegria
acumulado	medo
decreto	nojo
interdição	raiva
acribologia	surpresa
atraso	tristeza
pascer	alegria
junto	medo
prescrição	nojo
mas	raiva
nitidez	surpresa
impotência	tristeza
atrair	alegria
juntado	medo
regulamento	nojo
nó	raiva
brevidade	surpresa
pessimismo	tristeza
cativar	alegria
fortemente	medo
caracterização	nojo
pior	raiva
concisão	surpresa
cepticismo	tristeza
mimar	alegria
profundamente	medo
especificação	nojo
porém	raiva
laconismo	surpresa
descômodo	tristeza
acarinhar	alegria
muitíssimo	medo
cômputo	nojo
remora	raiva
sintetismo	surpresa
descomodidade	tristeza
afagar	alegria
imensamente	medo
contagem	nojo
restrição	raiva
presteza	surpresa
incomodidade	tristeza
apaixonar-se	alegria
extremamente	medo
acomodação	nojo
tolhimento	raiva
regularidade	surpresa
desentusiasmo	tristeza
afeiçoar-se	alegria
descomedidamente	medo
arranjamento	nojo
tope	raiva
exação	surpresa
sequidão	tristeza
enamorar-se	alegria
grandemente	medo
arrumação	nojo
torniquete	raiva
indispensabilidade	surpresa
altruísmo	tristeza
encantar-se	alegria
altamente	medo
coordenação	nojo
trambolho	raiva
retificação	surpresa
desambição	tristeza
gostar	alegria
agudamente	medo
distribuição	nojo
vedação	raiva
revisão	surpresa
incúria	tristeza
destorroar	alegria
diverso	medo
estruturação	nojo
feeling	raiva
melhora	surpresa
desprestígio	tristeza
esterroar	alegria
vário	medo
ordenação	nojo
suscetibilidade	raiva
casa de correção	surpresa
esgotadura	tristeza
gradar	alegria
numeroso	medo
ordenamento	nojo
aporrinhação	raiva
reeducação	surpresa
esgoto	tristeza
gradear	alegria
abundante	medo
organização	nojo
arreliação	raiva
regeneração	surpresa
extinção	tristeza
doce	alegria
copioso	medo
localização	nojo
otimização	raiva
lisura	surpresa
empobrecimento	tristeza
açúcar	alegria
inúmero	medo
situação	nojo
desenvolvimento	raiva
requintamento	surpresa
despejo	tristeza
mel	alegria
diferente	medo
estado de espírito	nojo
adiantamento	raiva
sublime	surpresa
secagem	tristeza
afetuosidade	alegria
variado	medo
feição	nojo
avanço	raiva
malmequer	surpresa
enxugamento	tristeza
amorosidade	alegria
profuso	medo
humor	nojo
conferência	raiva
bem-me-quer	surpresa
drenagem	tristeza
suavidade	alegria
farto	medo
bossa	nojo
seleção	raiva
febre dengue	surpresa
desvanecimento	tristeza
brandura	alegria
múltiplo	medo
ordens	nojo
eleição	raiva
insinuação	surpresa
frigidez	tristeza
alvedrio	alegria
excessivo	medo
serviço	nojo
casting	raiva
requebro	surpresa
gelo	tristeza
líbito	alegria
exagerado	medo
senhorio	nojo
averiguação	raiva
alarde	surpresa
algidez	tristeza
mando	alegria
exorbitante	medo
dispor	nojo
investigação	raiva
exibicionismo	surpresa
frialdade	tristeza
moto-próprio	alegria
superabundante	medo
regra	nojo
verificação	raiva
pavonada	surpresa
neutralidade	tristeza
nução	alegria
sobejo	medo
preceito	nojo
constatação	raiva
pavoneamento	surpresa
calo	tristeza
volição	alegria
nímio	medo
cláusula	nojo
escrutínio	raiva
pavoneio	surpresa
friúra	tristeza
capricheira	alegria
grande	medo
condicionante	nojo
indagação	raiva
afetação	surpresa
regelo	tristeza
à vontade	alegria
deveras	medo
emprego	nojo
pesquisa	raiva
amaneiramento	surpresa
mármore	tristeza
boa vontade	alegria
sobremaneira	medo
à disposição	nojo
consulta	raiva
faceirice	surpresa
neve	tristeza
celebração	alegria
sobremodo	medo
destemer	nojo
liquidação	raiva
presunção	surpresa
álgido	tristeza
comemoração	alegria
assaz	medo
ardidez	nojo
intensificação	raiva
vaidade	surpresa
fresco	tristeza
festividade	alegria
assustadoramente	medo
arreganho	nojo
limpeza	raiva
astúcia	surpresa
cruento	tristeza
festejo	alegria
indefinidamente	medo
inobservância	nojo
fuzuê	raiva
hipocrisia	surpresa
empedernido	tristeza
festança	alegria
extraordinariamente	medo
intimidade	nojo
frege	raiva
maquiavelismo	surpresa
seco	tristeza
festim	alegria
repetidamente	medo
familiaridade	nojo
fuzarca	raiva
choradeira	surpresa
contido	tristeza
solenidade	alegria
frequentemente	medo
informalidade	nojo
aparência	raiva
atraente	surpresa
calmo	tristeza
cerimônia	alegria
sempre	medo
intromissão	nojo
indício	raiva
cativante	surpresa
controlado	tristeza
sarau	alegria
amiúde	medo
guapeza	nojo
água	raiva
dengueiro	surpresa
impassível	tristeza
banquete	alegria
abundantemente	medo
possança	nojo
saliva	raiva
encantador	surpresa
impertubável	tristeza
pândega	alegria
em quantidade	medo
fígado	nojo
cuspe	raiva
insinuante	surpresa
tranquilo	tristeza
carícia	alegria
nenhum	medo
cacetada	nojo
cuspo	raiva
sedutor	surpresa
apático	tristeza
afago	alegria
qualquer	medo
história	nojo
babugem	raiva
sensual	surpresa
desanimado	tristeza
feriado	alegria
maior	medo
seringação	nojo
espuma	raiva
afetado	surpresa
desinteressado	tristeza
recesso	alegria
assim	medo
derriço	nojo
gosma	raiva
amaneirado	surpresa
frouxo	tristeza
trégua	alegria
excepcional	medo
buchada	nojo
mucosidade	raiva
delambido	surpresa
indiferente	tristeza
siriri	alegria
atípico	medo
livre	nojo
seiva	raiva
deslambido	surpresa
insípido	tristeza
gabo	alegria
incomum	medo
vago	nojo
visco	raiva
elegante	surpresa
insosso	tristeza
louvaminha	alegria
inusitado	medo
desocupado	nojo
pápula	raiva
faceiro	surpresa
lasso	tristeza
claridade	alegria
raro	medo
desguarnecido	nojo
a despeito de	raiva
presumido	surpresa
adulterado	tristeza
luz	alegria
singular	medo
desabitado	nojo
bile	raiva
presunçoso	surpresa
falso	tristeza
luminosidade	alegria
grande parte de	medo
despovoado	nojo
borbulhagem	raiva
pretensioso	surpresa
forjado	tristeza
resplandecência	alegria
muito bom	medo
aliviado	nojo
foco	raiva
requebrado	surpresa
fraudado	tristeza
esperança	alegria
satisfatório	medo
derramado	nojo
enfoque	raiva
vaidoso	surpresa
frígido	tristeza
guia	alegria
suficiente	medo
descarregado	nojo
Diana	raiva
ardiloso	surpresa
inapetente	tristeza
farol	alegria
suficientemente	medo
despejado	nojo
Juno	raiva
manhoso	surpresa
arrepio	tristeza
bússola	alegria
excepcionalmente	medo
entornado	nojo
satélite	raiva
choramingas	surpresa
calafrio	tristeza
engenho	alegria
imensurável	medo
esvaziado	nojo
secundário	raiva
chorão	surpresa
friagem	tristeza
dia	alegria
desmesurado	medo
vazado	nojo
luar	raiva
melindroso	surpresa
invernia	tristeza
guarda-sol	alegria
ilimitado	medo
carente	nojo
lunação	raiva
mimado	surpresa
pé frio	tristeza
smile	alegria
incalculável	medo
destituído	nojo
mês	raiva
relacionamento	surpresa
desqualificação	tristeza
apodo	alegria
incomensurável	medo
privado	nojo
menstruação	raiva
namoro	surpresa
passividade	tristeza
ironia	alegria
incontável	medo
frívolo	nojo
mênstruo	raiva
romance	surpresa
ataraxia	tristeza
caçoada	alegria
infindo	medo
fútil	nojo
regras	raiva
vínculo	surpresa
estacionamento	tristeza
chacoteação	alegria
infinito	medo
oco	nojo
catamênio	raiva
fuxico	surpresa
fixidez	tristeza
chacotice	alegria
agigantado	medo
superficial	nojo
chico	raiva
namorico	surpresa
imobilismo	tristeza
chalaça	alegria
ingente	medo
tolo	nojo
menarquia	raiva
paixoneta	surpresa
ignorância	tristeza
chança	alegria
mastodôntico	medo
baldado	nojo
menorreia	raiva
elo	surpresa
sensualidade	tristeza
chasco	alegria
monstruoso	medo
fracassado	nojo
paquete	raiva
amante	surpresa
analdia	tristeza
chincalhada	alegria
paquidérmico	medo
frustrado	nojo
período menstrual	raiva
garoto	surpresa
sopor	tristeza
chufa	alegria
amplo	medo
infrutífero	nojo
aluamento	raiva
namorado	surpresa
coma	tristeza
debique	alegria
espaçoso	medo
inútil	nojo
berra	raiva
pequeno	surpresa
madorna	tristeza
desfruto	alegria
extenso	medo
vão	nojo
pressuposição	raiva
xodó	surpresa
madorra	tristeza
dichote	alegria
vasto	medo
enganoso	nojo
subentendido	raiva
mimoso	surpresa
mangona	tristeza
dictério	alegria
profundo	medo
hipócrita	nojo
sugestão	raiva
devotamento	surpresa
sornice	tristeza
galhofa	alegria
complexo	medo
mentiroso	nojo
suposição	raiva
sexo	surpresa
madraçaria	tristeza
gracejo	alegria
considerável	medo
espaço	nojo
inferência	raiva
ato sexual	surpresa
calaçaria	tristeza
irrisão	alegria
espantoso	medo
hiato	nojo
comprometimento	raiva
coito	surpresa
mândria	tristeza
ludíbrio	alegria
fabuloso	medo
intervalo	nojo
enredo	raiva
cópula	surpresa
mandriice	tristeza
mangação	alegria
fantástico	medo
lacuna	nojo
bullying	raiva
copulação	surpresa
vadiação	tristeza
matraca	alegria
fenomenal	medo
vacuidade	nojo
vírus	raiva
acasalamento	surpresa
vadiagem	tristeza
mofa	alegria
formidável	medo
insaciabilidade	nojo
unha	raiva
intercurso	surpresa
vagabundagem	tristeza
momo	alegria
forte	medo
falecimento	nojo
dedo	raiva
mina	surpresa
tardança	tristeza
motejo	alegria
maravilhoso	medo
óbito	nojo
mão	raiva
facciosismo	surpresa
delonga	tristeza
pela	alegria
em excesso	medo
finamento	nojo
gadanho	raiva
parcialidade	surpresa
desleixe	tristeza
pilhéria	alegria
em demasia	medo
fenecimento	nojo
gafa	raiva
injustiça	surpresa
anistia	tristeza
remoque	alegria
além da conta	medo
passamento	nojo
grifo	raiva
cruxificação	surpresa
salvação	tristeza
sarcasmo	alegria
além da medida	medo
decesso	nojo
gatázio	raiva
lágrimas	surpresa
encaminhamento	tristeza
sátira	alegria
além disso	medo
defunção	nojo
fibra	raiva
aliciamento	surpresa
direcionamento	tristeza
tiro	alegria
além desse fato	medo
libitina	nojo
rapacidade	raiva
corrompimento	surpresa
envio	tristeza
tripúdio	alegria
além do mais	medo
trânsito	nojo
controle	raiva
persuasão	surpresa
remessa	tristeza
achicalhe	alegria
além de que	medo
traspasse	nojo
jugo	raiva
perversão	surpresa
expedição	tristeza
achincalhação	alegria
ademais	medo
traspassamento	nojo
dominação	raiva
calabouço	surpresa
seguimento	tristeza
achincalhamento	alegria
de mais a mais	medo
exício	nojo
gavinha	raiva
cela	surpresa
alusão	tristeza
chincalho	alegria
aliás	medo
desaparecimento	nojo
expectativa	raiva
clausura	surpresa
menção	tristeza
escarnecimento	alegria
outros	medo
desaparição	nojo
olho grande	raiva
cubículo	surpresa
citação	tristeza
escarninho	alegria
restantes	medo
ocaso	nojo
orexia	raiva
enxovia	surpresa
referimento	tristeza
escárnio	alegria
resto	medo
pena de morte	nojo
desnutrição	raiva
ergástulo	surpresa
retrocesso	tristeza
risota	alegria
mais	medo
soldadura	nojo
subalimentação	raiva
estufilha	surpresa
mitigação	tristeza
deboche	alegria
exuberante	medo
soldagem	nojo
subnutrição	raiva
ferros	surpresa
consolo	tristeza
achincalhe	alegria
excedente	medo
breu	nojo
unha de fome	raiva
gaiola	surpresa
consolação	tristeza
pulha	alegria
hiperbólico	medo
chona	nojo
precedência	raiva
grades	surpresa
lenitivo	tristeza
moca	alegria
abusivo	medo
noitada	nojo
pimenta	raiva
jaula	surpresa
refrigério	tristeza
joguete	alegria
por demais	medo
patuscada	nojo
entrada	raiva
masmorra	surpresa
intermissão	tristeza
trote	alegria
supérfluo	medo
gandaia	nojo
ingresso	raiva
carceragem	surpresa
intermitência	tristeza
flauteio	alegria
desnecessário	medo
desconhecimento	nojo
admissão	raiva
confinamento	surpresa
apesar de	tristeza
surriada	alegria
dispensável	medo
obscurantismo	nojo
introdução	raiva
encarceramento	surpresa
não obstante	tristeza
derrisão	alegria
prescindível	medo
incultura	nojo
avizinhação	raiva
encerramento	surpresa
independentemente de	tristeza
jocosidade	alegria
escusado	medo
insipiência	nojo
avizinhamento	raiva
enclausuramento	surpresa
ainda que	tristeza
pagode	alegria
redundante	medo
insciência	nojo
abeiramento	raiva
cativeiro	surpresa
mesmo que	tristeza
brega	alegria
desregrado	medo
vigília	nojo
achegamento	raiva
corda	surpresa
sem embargo de	tristeza
cafona	alegria
descomedido	medo
véspera	nojo
passagem	raiva
grilhão	surpresa
conquanto	tristeza
jeca	alegria
imoderado	medo
caridade	nojo
alcance	raiva
peia	surpresa
má vontade	tristeza
bimbo	alegria
incontrolável	medo
pêsame	nojo
obtenção	raiva
relevância	surpresa
oferece	tristeza
kitsch	alegria
sobreposse	medo
maviosidade	nojo
aquisição	raiva
utilidade	surpresa
destaca	tristeza
inestético	alegria
sobejamente	medo
credo	nojo
conexão	raiva
magnitude	surpresa
vitima	tristeza
provinciano	alegria
imoderadamente	medo
credulidade	nojo
comunicação	raiva
vulto	surpresa
mansidão	tristeza
espampanante	alegria
fartamente	medo
crença	nojo
convivência	raiva
monta	surpresa
pacificidade	tristeza
esquisito	alegria
profusamente	medo
fé	nojo
comportamento	raiva
préstimo	surpresa
paz	tristeza
estrambólico	alegria
verdadeiramente	medo
compressão	nojo
disponibilidade	raiva
curiosidade	surpresa
placidez	tristeza
excêntrico	alegria
totalmente	medo
contração	nojo
acometimento	raiva
egoísmo	surpresa
quietude	tristeza
extravagante	alegria
surpreendentemente	medo
estreitamento	nojo
promoção	raiva
individualismo	surpresa
sossego	tristeza
heteróclito	alegria
eminentemente	medo
retração	nojo
subida	raiva
egocentrismo	surpresa
plenidão	tristeza
burlesco	alegria
elevadamente	medo
filantropia	nojo
ascensão	raiva
juro	surpresa
baixada	tristeza
caricato	alegria
seriamente	medo
oscilar	nojo
acessão	raiva
dividendo	surpresa
baixos	tristeza
caricaturesco	alegria
tremido	medo
balançar	nojo
costume	raiva
obscurecimento	surpresa
vale	tristeza
cômico	alegria
horripilação	medo
balouçar	nojo
praxe	raiva
obumbração	surpresa
demissão	tristeza
engraçado	alegria
balismo	medo
atrever-se	nojo
hábito	raiva
ofuscamento	surpresa
despedimento	tristeza
grotesco	alegria
palpitação	medo
ousar	nojo
vezo	raiva
apertão	surpresa
rebaixo	tristeza
picaresco	alegria
tremedeira	medo
compensar	nojo
artigos	raiva
puxão	surpresa
capachismo	tristeza
risível	alegria
trêmulo	medo
contrabalançar	nojo
roupas	raiva
safanão	surpresa
atrofia	tristeza
contraditório	alegria
mesura	medo
equilibrar	nojo
vestuário	raiva
repelão	surpresa
declinação	tristeza
ilógico	alegria
panegírico	medo
igualar	nojo
ária	raiva
repuxão	surpresa
emagrecimento	tristeza
incoerente	alegria
salamaleque	medo
embalar	nojo
canção	raiva
empuxão	surpresa
eclipse	tristeza
insensato	alegria
acato	medo
impelir	nojo
cantiga	raiva
epilepsia	surpresa
precarização	tristeza
irrefletido	alegria
observância	medo
ariscar	nojo
modinha	raiva
sequela	surpresa
descida	tristeza
paradoxal	alegria
realização	medo
contrapesar	nojo
música	raiva
resultante	surpresa
silogismo	tristeza
avarento	alegria
execução	medo
equiponderar	nojo
toada	raiva
impelido	surpresa
ilação	tristeza
avaro	alegria
vassalagem	medo
librar	nojo
maior frequência	raiva
empurrado	surpresa
ágio	tristeza
mão de vaca	alegria
tutela	medo
balancear	nojo
maioria	raiva
lançado	surpresa
retenção	tristeza
mesquinho	alegria
escravidão	medo
sustentar	nojo
coqueluche	raiva
atirado	surpresa
défice	tristeza
pão-duro	alegria
heteronomia	medo
suportar	nojo
popularidade	raiva
projetado	surpresa
merma	tristeza
sovina	alegria
disciplina	medo
suster	nojo
divulgação	raiva
disparado	surpresa
minguamento	tristeza
desprezível	alegria
docilidade	medo
segurar	nojo
publicação	raiva
desordenação	surpresa
restringimento	tristeza
exíguo	alegria
tributo	medo
aguentar	nojo
difusão	raiva
desordenamento	surpresa
estulto	tristeza
ínfimo	alegria
formigueiro	medo
apoiar	nojo
propagação	raiva
Entropia	surpresa
idiota	tristeza
irrisório	alegria
quebra-cabeça	medo
amparar	nojo
propalação	raiva
desarticulação	surpresa
imbecil	tristeza
minguado	alegria
quebra-cabeças	medo
escorar	nojo
ritmo	raiva
desconexão	surpresa
lerdaço	tristeza
módico	alegria
dor de cabeça	medo
firmar	nojo
cadência	raiva
desvairamento	surpresa
néscio	tristeza
parco	alegria
arremesso	medo
distribuir	nojo
velocidade	raiva
indisciplina	surpresa
parvo	tristeza
reduzido	alegria
atemorização	medo
dividir	nojo
andamento	raiva
quiprocó	surpresa
pateta	tristeza
gueto	alegria
bravata	medo
subdividir	nojo
marcha	raiva
zorra	surpresa
apalermado	tristeza
ghetto	alegria
cominação	medo
partilhar	nojo
progresso	raiva
zona	surpresa
louco	tristeza
autorização	alegria
intimação	medo
repartir	nojo
curso	raiva
bebedeira	surpresa
maluco	tristeza
concessão	alegria
ameaço	medo
comparticipar	nojo
amoladura	raiva
baile	surpresa
bobo	tristeza
deferimento	alegria
prenúncio	medo
ficar	nojo
queimação	raiva
rapioca	surpresa
trouxa	tristeza
outorga	alegria
assiduidade	medo
manter-se	nojo
azoada	raiva
gemido	surpresa
raso	tristeza
aval	alegria
rapidez	medo
aguentar-se	nojo
emperramento	raiva
sussurro	surpresa
lambão	tristeza
adesão	alegria
agilidade	medo
conter	nojo
emperro	raiva
murmúrio	surpresa
otário	tristeza
aderência	alegria
celeridade	medo
refrear	nojo
falência	raiva
cicio	surpresa
tantã	tristeza
acedência	alegria
ligeireza	medo
deter	nojo
dada	raiva
arfada	surpresa
peco	tristeza
assenso	alegria
ação	medo
domar	nojo
manipanço	raiva
arfadura	surpresa
desajeitado	tristeza
consenso	alegria
busca	medo
enfrear	nojo
bagata	raiva
respiradouro	surpresa
arara	tristeza
unanimidade	alegria
procura	medo
travar	nojo
caruara	raiva
respiração	surpresa
atoleimado	tristeza
consonância	alegria
sindicância	medo
reprimir	nojo
mascote	raiva
quero	surpresa
babaquara	tristeza
concertação	alegria
inquirição	medo
sopear	nojo
puçanga	raiva
balouço	surpresa
banana	tristeza
conciliação	alegria
inquérito	medo
classificar	nojo
fetiche	raiva
baloiço	surpresa
basbaque	tristeza
avença	alegria
devassa	medo
qualificar	nojo
jacaré	raiva
vaivém	surpresa
beócio	tristeza
concórdia	alegria
carruagem	medo
aferir	nojo
mocó	raiva
abanadela	surpresa
bestalhão	tristeza
congraçamento	alegria
coche	medo
ajuizar	nojo
alquebrado	raiva
abanação	surpresa
boboca	tristeza
harmonização	alegria
sege	medo
graduar	nojo
debilitado	raiva
rebolado	surpresa
leso	tristeza
anuição	alegria
tipoia	medo
aquilatar	nojo
langoroso	raiva
bamboleio	surpresa
paspalho	tristeza
confirmação	alegria
carroça	medo
conceituar	nojo
inconciliabilidade	raiva
meneio	surpresa
tatibitate	tristeza
abonação	alegria
empenhamento	medo
julgar	nojo
inconformidade	raiva
remelexo	surpresa
zebroide	tristeza
outorgamento	alegria
pistolão	medo
reputar	nojo
desconformidade	raiva
resumo	surpresa
avoado	tristeza
valorização	alegria
cartucho	medo
pensar	nojo
duelo	raiva
análise	surpresa
coió	tristeza
corroboração	alegria
mediação	medo
refletir	nojo
escaramuça	raiva
estudo	surpresa
microcéfalo	tristeza
legalização	alegria
cunha	medo
equacionar	nojo
liça	raiva
examinação	surpresa
papelão	tristeza
ratificação	alegria
penhora	medo
apreçar	nojo
pugilato	raiva
padrão	surpresa
luca	tristeza
roboração	alegria
penhor	medo
taxar	nojo
requesta	raiva
avançamento	surpresa
panaca	tristeza
validação	alegria
hipoteca	medo
orçar	nojo
sururu	raiva
saliência	surpresa
tombo	tristeza
homologação	alegria
promessa	medo
cotar	nojo
angu	raiva
projeção	surpresa
caída	tristeza
legitimação	alegria
engajamento	medo
estabelecer	nojo
certame	raiva
libração	surpresa
abismo	tristeza
classificação	alegria
imaleabilidade	medo
determinar	nojo
desaguisado	raiva
alternância	surpresa
eversão	tristeza
qualificação	alegria
crimeza	medo
fixar	nojo
galho	raiva
nutação	surpresa
embeiçamento	tristeza
passe	alegria
sisudez	medo
estipular	nojo
pendenga	raiva
estremecida	surpresa
rabicho	tristeza
autenticação	alegria
princípios	medo
tabelar	nojo
rusga	raiva
chacoalhão	surpresa
decaída	tristeza
visto	alegria
tabu	medo
contar	nojo
salseiro	raiva
atracão	surpresa
desmoronamento	tristeza
passaporte	alegria
meticulosidade	medo
computar	nojo
sangangu	raiva
sacão	surpresa
esfacelamento	tristeza
alvará	alegria
minúcia	medo
quantificar	nojo
testilha	raiva
ronco	surpresa
outono	tristeza
privilégio	alegria
remordimento	medo
suputar	nojo
competição	raiva
corrida	surpresa
caducidade	tristeza
sim	alegria
circunspeção	medo
medir	nojo
concorrência	raiva
carreira	surpresa
declive	tristeza
chancela	alegria
tento	medo
mensurar	nojo
rompimento	raiva
perdida	surpresa
declividade	tristeza
apoiado	alegria
ocupação	medo
dimensionar	nojo
dissidência	raiva
afetada	surpresa
declívio	tristeza
voto	alegria
aprimorado	medo
esmar	nojo
dissídio	raiva
egressão	surpresa
decaimento	tristeza
bênção	alegria
caprichado	medo
bitolar	nojo
pendência	raiva
desmembramento	surpresa
afrouxamento	tristeza
assunção	alegria
esmerado	medo
pressupor	nojo
questiúncula	raiva
egresso	surpresa
escombros	tristeza
aceitamento	alegria
impecável	medo
pressentir	nojo
prélio	raiva
escapada	surpresa
restos	tristeza
acolhida	alegria
perfeito	medo
conjeturar	nojo
laboração	raiva
escapadela	surpresa
ossada	tristeza
acolhimento	alegria
primoroso	medo
crer	nojo
derriça	raiva
escapulida	surpresa
extermínio	tristeza
receptividade	alegria
meditado	medo
depreender	nojo
justa	raiva
fugida	surpresa
desmoralização	tristeza
polidez	alegria
pensado	medo
deduzir	nojo
retesia	raiva
deserção	surpresa
bancarrota	tristeza
cavalheirismo	alegria
ponderado	medo
inferir	nojo
tendepá	raiva
escapula	surpresa
insolvência	tristeza
política	alegria
refletido	medo
prezar	nojo
pane	raiva
fugacidade	surpresa
craque	tristeza
polimento	alegria
calculado	medo
adorar	nojo
danificação	raiva
escape	surpresa
falimento	tristeza
civilidade	alegria
esperado	medo
amar	nojo
ruptura	raiva
vazamento	surpresa
reflexo	tristeza
galanteria	alegria
previsto	medo
reverenciar	nojo
inutilização	raiva
derramamento	surpresa
vestígio	tristeza
salva	alegria
proposital	medo
cultuar	nojo
esfacelo	raiva
escoamento	surpresa
reminiscência	tristeza
cortejo	alegria
intencional	medo
admirar	nojo
incorreção	raiva
escapamento	surpresa
caligem	tristeza
rapapé	alegria
propositado	medo
contemplar	nojo
inexatidão	raiva
ocasião	surpresa
blecaute	tristeza
zumbaia	alegria
premeditado	medo
mirar	nojo
disformidade	raiva
ensejo	surpresa
apagão	tristeza
didática	alegria
deliberado	medo
fitar	nojo
distorção	raiva
brecha	surpresa
turvamento	tristeza
instrução	alegria
queda-d'água	medo
criticar	nojo
má-formação	raiva
aberta	surpresa
turvação	tristeza
pedagogia	alegria
cachoeira	medo
cogitar	nojo
malformação	raiva
momento	surpresa
opacidade	tristeza
competência	alegria
cascata	medo
investigar	nojo
balda	raiva
sobra	surpresa
mistério	tristeza
conhecimento	alegria
transição	medo
explorar	nojo
pecha	raiva
margem	surpresa
sepultura	tristeza
cultura	alegria
cabriola	medo
pesquisar	nojo
tinha	raiva
deslocamento	surpresa
inferioridade	tristeza
perícia	alegria
pincho	medo
averiguar	nojo
cinca	raiva
desocupação	surpresa
vulgaridade	tristeza
saber	alegria
pinote	medo
verificar	nojo
nequice	raiva
emigração	surpresa
sujeira	tristeza
tarimba	alegria
pulo	medo
sondar	nojo
abertura	raiva
remoção	surpresa
lodo	tristeza
maneiras	alegria
bote	medo
procurar	nojo
fenda	raiva
saque	surpresa
chulice	tristeza
modos	alegria
catarata	medo
perscrutar	nojo
greta	raiva
renda	surpresa
futricagem	tristeza
adestramento	alegria
passada	medo
perquirir	nojo
lasca	raiva
exoneração	surpresa
sabujice	tristeza
domesticação	alegria
corcovo	medo
escrutar	nojo
paráclese	raiva
impeachment	surpresa
cafajestada	tristeza
amestramento	alegria
tacão	medo
escrutinar	nojo
racha	raiva
asilo	surpresa
suja	tristeza
domação	alegria
berreiro	medo
ver	nojo
rachadura	raiva
refúgio	surpresa
putrefação	tristeza
humanização	alegria
calvície	medo
ler	nojo
janela	raiva
retiro	surpresa
depredação	tristeza
treinamento	alegria
alopecia	medo
vasculhar	nojo
arremetida	raiva
ida	surpresa
massacre	tristeza
treino	alegria
atemorizamento	medo
esgravatar	nojo
acometida	raiva
êxodo	surpresa
exterminação	tristeza
obséquio	alegria
consumo	medo
escarafunchar	nojo
cometida	raiva
despedida	surpresa
chacina	tristeza
donaire	alegria
gasto	medo
comentar	nojo
ofensiva	raiva
adeus	surpresa
mortandade	tristeza
garbosidade	alegria
cárie	medo
decompor	nojo
opugnação	raiva
largada	surpresa
despesa	tristeza
tato	alegria
paralisia	medo
dissecar	nojo
desestima	raiva
start	surpresa
dispêndio	tristeza
leveza	alegria
premonição	medo
esmiuçar	nojo
contravenção	raiva
chiste	surpresa
fosso	tristeza
sutileza	alegria
presciência	medo
esquadrinhar	nojo
descumprimento	raiva
facécia	surpresa
algar	tristeza
detalhe	alegria
divinação	medo
minuciar	nojo
incumprimento	raiva
desafio	surpresa
antro	tristeza
pormenor	alegria
gaguejamento	medo
psicanalisar	nojo
solidez	raiva
serão	surpresa
catacumba	tristeza
particularidade	alegria
gaguejo	medo
achar	nojo
consistência	raiva
recepção	surpresa
caverna	tristeza
acuidade	alegria
hipótese	medo
acreditar	nojo
implacabilidade	raiva
lote	surpresa
covil	tristeza
sinceridade	alegria
conjectura	medo
sentir	nojo
rispidez	raiva
quadrilha	surpresa
furna	tristeza
hospitalidade	alegria
questionável	medo
meditar	nojo
secura	raiva
gangue	surpresa
gruta	tristeza
candura	alegria
contestável	medo
matutar	nojo
pindaíba	raiva
corja	surpresa
lapa	tristeza
confete	alegria
discutível	medo
raciocinar	nojo
grosseria	raiva
horda	surpresa
cava	tristeza
lhanura	alegria
suspicaz	medo
cuidar	nojo
indelicadeza	raiva
cambada	surpresa
dessemelhança	tristeza
gratuidade	alegria
inquietante	medo
discorrer	nojo
abrutamento	raiva
súcia	surpresa
alteridade	tristeza
quindim	alegria
congeminação	medo
reflexionar	nojo
má-criação	raiva
saimento	surpresa
heterogeneidade	tristeza
sociabilidade	alegria
grilo	medo
elucubrar	nojo
eficácia	raiva
rolé	surpresa
defasagem	tristeza
aticismo	alegria
revelia	medo
lucubrar	nojo
eficiência	raiva
caminhada	surpresa
desnivelamento	tristeza
normas	alegria
contempla	medo
ter em conta	nojo
viço	raiva
expediente	surpresa
diferencial	tristeza
galantaria	alegria
implica	medo
levar em conta	nojo
cometimento	raiva
exportação	surpresa
déficit	tristeza
diplomacia	alegria
reflete	medo
atentar	nojo
efetuação	raiva
comercialização	surpresa
aminguamento	tristeza
inconsistência	alegria
remói	medo
interessar-se	nojo
entrepresa	raiva
venda	surpresa
continência	tristeza
penetração	alegria
conseguimento	medo
honrar	nojo
interpresa	raiva
vendagem	surpresa
controlo	tristeza
bom-tom	alegria
atingimento	medo
valorizar	nojo
tentame	raiva
transferência	surpresa
moderação	tristeza
finesse	alegria
fusão	medo
acatar	nojo
tentativa	raiva
estrondo	surpresa
refreamento	tristeza
simplicidade	alegria
integração	medo
conceber	nojo
empresa	raiva
trupe	surpresa
subjugação	tristeza
naturalidade	alegria
incorporação	medo
tomar	nojo
entidade	raiva
encontrada	surpresa
descimento	tristeza
franqueza	alegria
identificação	medo
especular	nojo
firma	raiva
assédio	surpresa
redutor	tristeza
lealdade	alegria
anabolismo	medo
simpatizar	nojo
atuação	raiva
surtida	surpresa
luva	tristeza
alerta	alegria
digestão	medo
apegar-se	nojo
funcionamento	raiva
enxovalhamento	surpresa
abreviação	tristeza
prestar atenção	alegria
semelhança	medo
benquerer	nojo
operação	raiva
impropério	surpresa
síntese	tristeza
propina	alegria
analogia	medo
reconhecer	nojo
profissão	raiva
crítica	surpresa
abreviatura	tristeza
adicional	alegria
cognição	medo
venerar	nojo
ofício	raiva
linha	surpresa
acrônimo	tristeza
convite	alegria
erudição	medo
contabilizar	nojo
tarefa	raiva
vanguarda	surpresa
sigla	tristeza
lambujem	alegria
entender	medo
antever	nojo
mister	raiva
corrosão	surpresa
símbolo	tristeza
xixica	alegria
parecer	medo
entrever	nojo
exercício	raiva
proposta	surpresa
consumpção	tristeza
lambidela	alegria
julgamento	medo
suspeitar	nojo
desempenho	raiva
piora	surpresa
atrição	tristeza
luvas	alegria
aliança	medo
escolher	nojo
performance	raiva
deterioramento	surpresa
erosão	tristeza
laurel	alegria
concerto	medo
assinalar	nojo
indústria	raiva
pioria	surpresa
ablação	tristeza
láurea	alegria
pacto	medo
marcar	nojo
pró-atividade	raiva
pioramento	surpresa
carnificina	tristeza
honraria	alegria
sinergia	medo
criar	nojo
recrescimento	raiva
agravação	surpresa
fuzilamento	tristeza
condecoração	alegria
sintonia	medo
indicar	nojo
recrudescência	raiva
fragmentação	surpresa
morticínio	tristeza
coroa	alegria
percebismo	medo
instaurar	nojo
estrépito	raiva
fratura	surpresa
açougue	tristeza
juros	alegria
arrecadação	medo
estatuir	nojo
fragor	raiva
fracionamento	surpresa
ceifa	tristeza
adiafa	alegria
cobrança	medo
desejar	nojo
afundamento	raiva
partição	surpresa
carniça	tristeza
molha	alegria
absorvência	medo
almejar	nojo
soçobro	raiva
quebradura	surpresa
genocídio	tristeza
mota	alegria
absorvimento	medo
alegrar-se	nojo
emulação	raiva
desagregação	surpresa
lerdice	tristeza
cafezinho	alegria
infiltração	medo
contentar-se	nojo
nadinha	raiva
descontinuação	surpresa
vagarosidade	tristeza
copinho	alegria
filtração	medo
regozijar-se	nojo
pouquinho	raiva
paragem	surpresa
vagareza	tristeza
cinzel	alegria
sucção	medo
lisonjear	nojo
idiossincrasia	raiva
cessação	surpresa
pausa	tristeza
escopro	alegria
ingestão	medo
sobre-estimar	nojo
súplica	raiva
rescisão	surpresa
lomba	tristeza
ajuda	alegria
deglutição	medo
aprender	nojo
pedido	raiva
dobra	surpresa
ronceirismo	tristeza
benesse	alegria
engolição	medo
educar-se	nojo
rogo	raiva
dobradura	surpresa
umidade	tristeza
égide	alegria
açambarcamento	medo
ilustrar-se	nojo
abrenúncio	raiva
prega	surpresa
lentura	tristeza
amparo	alegria
anexação	medo
instruir-se	nojo
clamor	raiva
vinco	surpresa
relento	tristeza
patrocínio	alegria
agnição	medo
preparar-se	nojo
sobranceria	raiva
ruga	surpresa
garoa	tristeza
proteção	alegria
proficiência	medo
compreender	nojo
soberba	raiva
saracoteio	surpresa
orvalho	tristeza
carta	alegria
escola	medo
consultar	nojo
soberbia	raiva
rampa	surpresa
cacimba	tristeza
missiva	alegria
ilustração	medo
decorar	nojo
impolidez	raiva
vertente	surpresa
molúria	tristeza
a favor	alegria
ciência	medo
gravar	nojo
descortesia	raiva
encosta	surpresa
rocio	tristeza
a favor de	alegria
gnose	medo
guardar	nojo
incivilidade	raiva
costado	surpresa
lassitude	tristeza
em favor de	alegria
abrangência	medo
memorizar	nojo
inurbanidade	raiva
quebrada	surpresa
formigamento	tristeza
por favor	alegria
abarcamento	medo
ensaiar	nojo
invasão	raiva
quebrado	surpresa
canga	tristeza
caixote	alegria
englobamento	medo
exercitar	nojo
malbarato	raiva
sobras	surpresa
sufocamento	tristeza
relicário	alegria
abraçamento	medo
praticar	nojo
imprevidência	raiva
atrofiamento	surpresa
dissolução	tristeza
boceta	alegria
usurpação	medo
treinar	nojo
desacatamento	raiva
raquitismo	surpresa
niilismo	tristeza
medalha	alegria
empossamento	medo
vigiar	nojo
desprimor	raiva
pauperização	surpresa
esmagamento	tristeza
insígnia	alegria
assenhoreamento	medo
debater	nojo
excurso	raiva
despersuasão	surpresa
pulverização	tristeza
fita	alegria
tomada	medo
discutir	nojo
deságio	raiva
matinada	surpresa
descaída	tristeza
paparicos	alegria
presa	medo
indagar	nojo
aviltação	raiva
amotinamento	surpresa
desmerecimento	tristeza
extremo	alegria
tomadia	medo
planejar	nojo
calúnia	raiva
tsunami	surpresa
emaciação	tristeza
cuidados	alegria
pertinência	medo
simular	nojo
difamação	raiva
abordagem	surpresa
morbidade	tristeza
sentimentos	alegria
detém	medo
tratar	nojo
maledicência	raiva
abordada	surpresa
resgate	tristeza
fosca	alegria
custódia	medo
versar	nojo
maldizer	raiva
aferramento	surpresa
acréscimo	tristeza
eventos	alegria
estada	medo
ir	nojo
boato	raiva
batido	surpresa
furto	tristeza
adulação	alegria
engasgo	medo
cursar	nojo
mexerico	raiva
rastro	surpresa
abafo	tristeza
lisonja	alegria
impedição	medo
fazer	nojo
ladrado	raiva
pista	surpresa
rarefação	tristeza
blandícia	alegria
sem embargo	medo
seguir	nojo
fofoca	raiva
canoa	surpresa
embigo	tristeza
blandície	alegria
geena	medo
aprofundar	nojo
desveneração	raiva
caçada	surpresa
protuberância	tristeza
cafuné	alegria
acautelamento	medo
escabichar	nojo
irrespeito	raiva
exploração	surpresa
centro	tristeza
afagamento	alegria
vigilância	medo
espiolhar	nojo
profanação	raiva
pontada	surpresa
núcleo	tristeza
presentes	alegria
tenência	medo
testar	nojo
xingamento	raiva
geral	surpresa
ponto central	tristeza
fúcsia	alegria
salvaguarda	medo
provar	nojo
longanimidade	raiva
canastra	surpresa
ponto de convergência	tristeza
gota	alegria
provimento	medo
inspecionar	nojo
abandonamento	raiva
batedeira	surpresa
ponto nuclear	tristeza
pingo	alegria
devotação	medo
interrogar	nojo
abdicação	raiva
tungada	surpresa
encurtamento	tristeza
pranto	alegria
dedicatória	medo
questionar	nojo
cessão	raiva
usada	surpresa
afinamento	tristeza
oferenda	alegria
inscrição	medo
revistar	nojo
desistência	raiva
comida	surpresa
espaçamento	tristeza
dom	alegria
mensagem	medo
vistoriar	nojo
humanitarismo	raiva
extravio	surpresa
lembranças	tristeza
policitação	alegria
oferecimento	medo
assistir	nojo
abjuramento	raiva
entrechoque	surpresa
respeitos	tristeza
licitação	alegria
trinque	medo
presenciar	nojo
abstinência	raiva
arrepelão	surpresa
escabiosa	tristeza
pechincha	alegria
timbre	medo
testemunhar	nojo
desencarregamento	raiva
junção	surpresa
flor-de-viúva	tristeza
queima	alegria
prestimosidade	medo
constatar	nojo
desincumbência	raiva
união	surpresa
saudades	tristeza
doação	alegria
aplicabilidade	medo
notar	nojo
dispensação	raiva
assembleia	surpresa
suspiros	tristeza
donativo	alegria
serventia	medo
perceber	nojo
franquia	raiva
congresso	surpresa
viúva	tristeza
esmola	alegria
funcionalidade	medo
espiar	nojo
imunidade	raiva
descobrimento	surpresa
viúvas	tristeza
oblação	alegria
administração	medo
espreitar	nojo
equanimidade	raiva
achamento	surpresa
chibante	tristeza
oblata	alegria
ministração	medo
espionar	nojo
despego	raiva
confluência	surpresa
feiticeiro	tristeza
imolação	alegria
investimento	medo
bisbilhotar	nojo
ai	raiva
convergência	surpresa
tijuca	tristeza
ofertório	alegria
adereço	medo
descobrir	nojo
melúria	raiva
espera	surpresa
banzeiro	tristeza
blindagem	alegria
guarnição	medo
advertir	nojo
jeremiada	raiva
tropeção	surpresa
abatido	tristeza
parapeito	alegria
colocação	medo
repreender	nojo
protestação	raiva
acho	surpresa
amofinado	tristeza
peitoril	alegria
sobreposição	medo
censurar	nojo
reivindicação	raiva
paulada	surpresa
amolado	tristeza
guarda	alegria
superposição	medo
admoestar	nojo
denúncia	raiva
chuvarada	surpresa
demolição	tristeza
abrigada	alegria
justaposição	medo
prevenir	nojo
participação	raiva
aguaceiro	surpresa
arrasamento	tristeza
abrigo	alegria
aposição	medo
replicar	nojo
acusação	raiva
latejo	surpresa
desmantelamento	tristeza
cobertura	alegria
inflição	medo
expressar	nojo
delação	raiva
doido	surpresa
obliteração	tristeza
reduto	alegria
aplicativo	medo
exprimir	nojo
incriminação	raiva
amalucado	surpresa
assolamento	tristeza
valhacouto	alegria
ombro	medo
avisar	nojo
criminação	raiva
lambada	surpresa
infestação	tristeza
dieta	alegria
carolice	medo
lembrar	nojo
inculpação	raiva
maníaco	surpresa
resíduo	tristeza
coberto	alegria
beatice	medo
observar-se	nojo
imputação	raiva
pulsação	surpresa
relíquia	tristeza
guarida	alegria
beataria	medo
cismar	nojo
libelo	raiva
taça	surpresa
resíduos	tristeza
sustento	alegria
beatismo	medo
ruminar	nojo
exprobação	raiva
tapona	surpresa
herpes	tristeza
anteparo	alegria
santimônia	medo
alegar	nojo
embuste	raiva
zurbada	surpresa
depravação	tristeza
traçado	alegria
monomania	medo
argumentar	nojo
fraude	raiva
mocada	surpresa
devassidão	tristeza
enxuto	alegria
neurose	medo
mencionar	nojo
dança	raiva
ripada	surpresa
envilecimento	tristeza
balaústre	alegria
aprazamento	medo
citar	nojo
imbróglio	raiva
coça	surpresa
prevaricação	tristeza
escudo	alegria
estabelecimento	medo
pretextar	nojo
alguma	raiva
maluqueira	surpresa
gradação	tristeza
preservação	alegria
marcação	medo
justificar	nojo
objurgação	raiva
cachação	surpresa
nuance	tristeza
regaço	alegria
afixação	medo
expor	nojo
objurgatória	raiva
direto	surpresa
enevoamento	tristeza
hospedagem	alegria
colagem	medo
arguir	nojo
esconjurar	raiva
pescoção	surpresa
anuviamento	tristeza
alojamento	alegria
estabilização	medo
arrazoar	nojo
descaminho	raiva
sapeca	surpresa
embaçamento	tristeza
socorro	alegria
imobilização	medo
envaidecer-se	nojo
sumiço	raiva
catatau	surpresa
embaciamento	tristeza
roupa	alegria
conservação	medo
gloriar-se	nojo
cancelamento	raiva
tacada	surpresa
nébula	tristeza
vestimenta	alegria
memorização	medo
jactar-se	nojo
supressão	raiva
passa	surpresa
apneia	tristeza
veste	alegria
jesuitismo	medo
orgulhar-se	nojo
arruinação	raiva
entrevero	surpresa
sacrilégio	tristeza
capa	alegria
elucubração	medo
ufanar-se	nojo
arruinamento	raiva
tropicão	surpresa
machucado	tristeza
abafador	alegria
memória	medo
vangloriar-se	nojo
libertinagem	raiva
tropeçar	surpresa
faniquito	tristeza
conchego	alegria
recordação	medo
desconfiar	nojo
precipício	raiva
contato	surpresa
chilique	tristeza
quente	alegria
plano	medo
duvidar	nojo
gangrena	raiva
tocadela	surpresa
esmaecimento	tristeza
sobretudo	alegria
probabilidade	medo
fantasiar	nojo
patologia	raiva
tocamento	surpresa
lipotimia	tristeza
suéter	alegria
provérbio	medo
sonhar	nojo
macacoa	raiva
som	surpresa
apsiquia	tristeza
cômodo	alegria
máxima	medo
idealizar	nojo
ressaca	raiva
sineta	surpresa
fanico	tristeza
luxúria	alegria
ditado	medo
inventar	nojo
desentendido	raiva
sirene	surpresa
trapo	tristeza
libidinagem	alegria
adágio	medo
idear	nojo
mórbido	raiva
repenique	surpresa
analose	tristeza
erotismo	alegria
aforismo	medo
elaborar	nojo
doente	raiva
traço	surpresa
esfalfação	tristeza
sensualismo	alegria
dito	medo
projetar	nojo
enfermo	raiva
laivo	surpresa
esfalfe	tristeza
sexualidade	alegria
apotegma	medo
traçar	nojo
axe	raiva
resquício	surpresa
repouso	tristeza
afrodisia	alegria
anexim	medo
prognosticar	nojo
chaga	raiva
rasto	surpresa
distensão	tristeza
bobeira	alegria
ideologia	medo
concluir	nojo
pústula	raiva
demão	surpresa
descontração	tristeza
besteira	alegria
filosofia	medo
atinar	nojo
úlcera	raiva
indireta	surpresa
licenciosidade	tristeza
patetice	alegria
doutrina	medo
identificar	nojo
ulceração	raiva
dica	surpresa
desoneração	tristeza
idiotice	alegria
ideais	medo
confiar	nojo
conspurcação	raiva
conselho	surpresa
diarreia	tristeza
tolice	alegria
significado	medo
esperar	nojo
estigma	raiva
orientação	surpresa
caganeira	tristeza
tontice	alegria
significação	medo
aprontar	nojo
porte	raiva
criatividade	surpresa
soltura	tristeza
baboseira	alegria
cacoete	medo
armar	nojo
desconfortável	raiva
pedra de toque	surpresa
hebetude	tristeza
asneira	alegria
jeitão	medo
organizar	nojo
embaraçoso	raiva
guerrilha	surpresa
mamparra	tristeza
imbecilidade	alegria
bizarrice	medo
preparar	nojo
constrangedor	raiva
mesa-redonda	surpresa
leseira	tristeza
palermice	alegria
estapafurdismo	medo
admitir	nojo
incomodador	raiva
debatimento	surpresa
mação	tristeza
parvoíce	alegria
exotismo	medo
interrogar-se	nojo
incomodante	raiva
palestra	surpresa
pânria	tristeza
estultícia	alegria
ratada	medo
predizer	nojo
incomodativo	raiva
refrega	surpresa
remancho	tristeza
necedade	alegria
ratice	medo
pressagiar	nojo
apetecer	raiva
torneio	surpresa
sorna	tristeza
sandice	alegria
telha	medo
vaticinar	nojo
pretender	raiva
defrontação	surpresa
pacholice	tristeza
asnice	alegria
cachaça	medo
adivinhar	nojo
tencionar	raiva
confrontação	surpresa
comodismo	tristeza
quinquilharia	alegria
vesânia	medo
prenunciar	nojo
intencionar	raiva
acareação	surpresa
côncavo	tristeza
niquice	alegria
xenofobia	medo
augurar	nojo
intentar	raiva
acareamento	surpresa
profundidade	tristeza
nada	alegria
preconcepção	medo
agourar	nojo
planear	raiva
rinha	surpresa
seio	tristeza
nica	alegria
rótulo	medo
agoirar	nojo
programar	raiva
compete	surpresa
câmara	tristeza
palha	alegria
diferenciação	medo
futurar	nojo
ter em vista	raiva
pleito	surpresa
câmera	tristeza
nuga	alegria
marginalização	medo
antecipar	nojo
aspirar	raiva
descarregamento	surpresa
entresseio	tristeza
nugacidade	alegria
arrolamento	medo
profetizar	nojo
ansiar	raiva
disparo	surpresa
reentrância	tristeza
bugiaria	alegria
descrição	medo
subentender	nojo
perseguir	raiva
dejeção	surpresa
nicho	tristeza
bufarinha	alegria
listamento	medo
aceitar	nojo
ambicionar	raiva
defecação	surpresa
alvéolo	tristeza
frioleira	alegria
filtragem	medo
atribuir	nojo
cobiçar	raiva
machucadura	surpresa
cavado	tristeza
guloseima	alegria
banalidade	medo
acusar	nojo
anelar	raiva
roxo	surpresa
encaixe	tristeza
gulodice	alegria
chavão	medo
condenar	nojo
suspirar	raiva
roxa	surpresa
escavação	tristeza
gulosice	alegria
lugar-comum	medo
culpabilizar	nojo
exigir	raiva
amassado	surpresa
grota	tristeza
iguaria	alegria
modelo	medo
imputar	nojo
ordenar	raiva
amassadela	surpresa
poço	tristeza
lambarice	alegria
padrão básico	medo
incriminar	nojo
mandar	raiva
amassadura	surpresa
recôncavo	tristeza
lambugem	alegria
tópico	medo
inculpar	nojo
obrigar	raiva
amolgadela	surpresa
socava	tristeza
palhaçada	alegria
trivialidade	medo
responsabilizar	nojo
impor	raiva
amolgadura	surpresa
toca	tristeza
bobice	alegria
clichê	medo
manipular	nojo
necessitar	raiva
amolgamento	surpresa
túmulo	tristeza
bufonaria	alegria
estéreo	medo
levar	nojo
precisar	raiva
entalhe	surpresa
sepulcro	tristeza
truanice	alegria
estereotipia	medo
inspirar	nojo
requerer	raiva
entalho	surpresa
alicerce	tristeza
arlequinada	alegria
molde	medo
interferir	nojo
demandar	raiva
entalha	surpresa
tunda	tristeza
momice	alegria
compra	medo
controlar	nojo
pedir	raiva
entalhamento	surpresa
terra	tristeza
comédia	alegria
expensa	medo
agir	nojo
carecer	raiva
entalhadura	surpresa
alçapão	tristeza
faculdades	alegria
arquejamento	medo
dominar	nojo
tentar	raiva
estouro	surpresa
biboca	tristeza
predicado	alegria
inalação	medo
obrar	nojo
experimentar	raiva
estalada	surpresa
cabouco	tristeza
dote	alegria
ideal	medo
operar	nojo
preferir	raiva
bernarda	surpresa
socavão	tristeza
favorece	alegria
desiderato	medo
empreender	nojo
optar	raiva
estropício	surpresa
barroco	tristeza
tenha	alegria
espero	medo
mover-se	nojo
eleger	raiva
mazorca	surpresa
fojo	tristeza
frescura	alegria
fermentação	medo
lidar	nojo
selecionar	raiva
rebordosa	surpresa
forame	tristeza
algaravia	alegria
fervedura	medo
trabalhar	nojo
decidir-se	raiva
turbulência	surpresa
solapa	tristeza
tropel	alegria
questionamento	medo
concretizar	nojo
consentir	raiva
insurgência	surpresa
furo	tristeza
falatório	alegria
ambivalência	medo
representar	nojo
autorizar	raiva
pronunciamento	surpresa
cavação	tristeza
chinfrinada	alegria
anfibolia	medo
interpretar	nojo
deixar	raiva
sondagem	surpresa
fisga	tristeza
falácia	alegria
anfibologia	medo
encenar	nojo
assentir	raiva
recolha	surpresa
fresta	tristeza
inferneira	alegria
dubieza	medo
encarnar	nojo
conceder	raiva
listagem	surpresa
frincha	tristeza
presepada	alegria
limbo	medo
funcionar	nojo
concordar	raiva
lista	surpresa
orifício	tristeza
trovoada	alegria
errada	medo
exercer	nojo
anuir	raiva
enumeração	surpresa
perfuração	tristeza
chiado	alegria
discricionariedade	medo
ocupar-se	nojo
dispor-se	raiva
rol	surpresa
ranhura	tristeza
grulhada	alegria
impropriedade	medo
encarregar-se	nojo
prestar-se	raiva
repertório	surpresa
rasgão	tristeza
guaiú	alegria
inseguridade	medo
proceder	nojo
oferecer-se	raiva
inventário	surpresa
branco	tristeza
vozerio	alegria
periculosidade	medo
contribuir	nojo
ameaçar	raiva
inventariação	surpresa
lanho	tristeza
mutreta	alegria
infixidez	medo
colaborar	nojo
aproximar-se	raiva
catalogação	surpresa
barracão	tristeza
motilidade	alegria
interrogatório	medo
facilitar	nojo
pairar	raiva
erguimento	surpresa
barraco	tristeza
moto	alegria
inquisição	medo
favorecer	nojo
idolatrar	raiva
alteamento	surpresa
casebre	tristeza
cinesia	alegria
quesito	medo
concorrer	nojo
sem querer	raiva
içamento	surpresa
choça	tristeza
locomoção	alegria
ateísmo	medo
auxiliar	nojo
solicitação	raiva
aumento	surpresa
choupana	tristeza
dinâmica	alegria
irreligiosidade	medo
valer	nojo
desejos	raiva
acrescento	surpresa
maloca	tristeza
meneamento	alegria
rabugice	medo
coagir	nojo
imaginativa	raiva
majoração	surpresa
pardieiro	tristeza
gesto	alegria
pedantismo	medo
constranger	nojo
inventividade	raiva
incremento	surpresa
tugúrio	tristeza
aceno	alegria
susceptibilidade	medo
forçar	nojo
criação	raiva
acrescentamento	surpresa
cafundó	tristeza
gesticulação	alegria
capanga	medo
intimidar	nojo
faz-de-conta	raiva
acrescimento	surpresa
cafundó do judas	tristeza
trejeito	alegria
barragem	medo
tutear	nojo
bijuteria	raiva
achega	surpresa
caixa-pregos	tristeza
partido	alegria
abacaxi	medo
compelir	nojo
apetite sexual	raiva
fidalguia	surpresa
cu de judas	tristeza
associação	alegria
enigma	medo
aliciar	nojo
energia vital	raiva
levada	surpresa
rego	tristeza
agremiação	alegria
charada	medo
aconselhar	nojo
satiríase	raiva
nascente	surpresa
vala	tristeza
sociedade	alegria
perquirição	medo
conduzir	nojo
incontinência	raiva
este	surpresa
carquilha	tristeza
mobilização	alegria
perquisição	medo
encorajar	nojo
carne	raiva
leste	surpresa
canal	tristeza
afogadilho	alegria
matéria	medo
impulsionar	nojo
impudicícia	raiva
oriente	surpresa
trilha	tristeza
tempo	alegria
ponto	medo
incentivar	nojo
estimulação	raiva
disponha	surpresa
estria	tristeza
espalhado	alegria
tese	medo
incitar	nojo
capital	raiva
abanador	surpresa
leiva	tristeza
murmurinho	alegria
item	medo
seduzir	nojo
metrópole	raiva
abanico	surpresa
álveo	tristeza
triga	alegria
capítulo	medo
suscitar	nojo
matriz	raiva
flabelo	surpresa
calha	tristeza
agraço	alegria
em questão	medo
incutir	nojo
mãe	raiva
leque	surpresa
canelura	tristeza
frescor	alegria
interpelação	medo
formular	nojo
central	raiva
ventana	surpresa
esteira	tristeza
verde	alegria
poltroneria	medo
cobrir	nojo
cerne	raiva
ventarola	surpresa
leira	tristeza
verdor	alegria
cintilante	medo
emboçar	nojo
polo	raiva
desajuste	surpresa
acanaladura	tristeza
verdura	alegria
cintilar	medo
guarnecer	nojo
base	raiva
travessura	surpresa
interseção	tristeza
vicejo	alegria
faiscante	medo
indutar	nojo
catedral	raiva
diabrura	surpresa
intersecção	tristeza
validade	alegria
faiscar	medo
revestir	nojo
sé	raiva
tropelia	surpresa
acidentado	tristeza
vigência	alegria
fulgurar	medo
transmitir	nojo
igreja	raiva
traquinice	surpresa
desnivelamente	tristeza
ênfase	alegria
efemeridade	medo
comunicar	nojo
domo	raiva
molecagem	surpresa
retrocessão	tristeza
oxigênio	alegria
impermanência	medo
condicionar	nojo
assento	raiva
peraltice	surpresa
recuada	tristeza
fluido	alegria
perecibilidade	medo
imprimir	nojo
cadeira	raiva
exiguidade	surpresa
recua	tristeza
flatulência	alegria
transitoriedade	medo
infundir	nojo
banco	raiva
estampido	surpresa
greve	tristeza
flato	alegria
acanho	medo
insinuar	nojo
suporte	raiva
arrocho	surpresa
parede	tristeza
ventosidade	alegria
bisonharia	medo
instilar	nojo
agiotagem	raiva
cerco	surpresa
estancamento	tristeza
apontamento	alegria
bisonhice	medo
insuflar	nojo
onzena	raiva
desfiladeiro	surpresa
engarrafamento	tristeza
fumaça	alegria
encalistração	medo
sugerir	nojo
hipertermia	raiva
angustura	surpresa
congestionamento	tristeza
refocilamento	alegria
encalistramento	medo
alentar	nojo
pirexia	raiva
estreito	surpresa
estiolamento	tristeza
alimento	alegria
encolha	medo
entusiasmar	nojo
temperatura	raiva
passo	surpresa
héctica	tristeza
alimentação	alegria
costumeira	medo
estimular	nojo
febre intermitente	raiva
cunho	surpresa
tísica	tristeza
subsistência	alegria
escorregadela	medo
excitar	nojo
impaludismo	raiva
embaraçamento	surpresa
hética	tristeza
nutrição	alegria
desacerto	medo
inflamar	nojo
malária	raiva
encabulação	surpresa
eufemismo	tristeza
nutrimento	alegria
erronia	medo
importar	nojo
maleita	raiva
pejamento	surpresa
abrandamento	tristeza
mantimento	alegria
geofagia	medo
interessar	nojo
paludismo	raiva
gestação	surpresa
tira-teimas	tristeza
fôlego	alegria
curteza	medo
aplicar-se	nojo
sezão	raiva
gravidez	surpresa
invídia	tristeza
bafo	alegria
insuficiência	medo
dedicar-se	nojo
sezões	raiva
prenhez	surpresa
zelotipia	tristeza
hálito	alegria
escória	medo
devotar-se	nojo
sezonismo	raiva
canudo	surpresa
mercantilismo	tristeza
aragem	alegria
borrão	medo
entregar-se	nojo
destinação	raiva
gafe	surpresa
quer	tristeza
brisa	alegria
jaça	medo
despertar	nojo
fito	raiva
desnorteamento	surpresa
interesses	tristeza
ar	alegria
poluição	medo
mover	nojo
mira	raiva
inflexão	surpresa
deseja	tristeza
fresca	alegria
trinca	medo
exortar	nojo
a propósito	raiva
transvio	surpresa
pinta	tristeza
bafagem	alegria
inocuidade	medo
concitar	nojo
a propósito de	raiva
deriva	surpresa
signo	tristeza
expressividade	alegria
inabilidade	medo
desafiar	nojo
convencimento	raiva
imprevisibilidade	surpresa
assinalamento	tristeza
fulgor	alegria
nulidade	medo
encasquetar	nojo
imodéstia	raiva
falcatrua	surpresa
carimbo	tristeza
engenhosidade	alegria
desnecessidade	medo
inculcar	nojo
empáfia	raiva
espeto	surpresa
ferro	tristeza
brilhantismo	alegria
ferrete	medo
atiçar	nojo
jactância	raiva
incógnita	surpresa
selo	tristeza
destreza	alegria
claudicação	medo
assanhar	nojo
bazófia	raiva
segredo	surpresa
sinete	tristeza
lepidez	alegria
inquinação	medo
açular	nojo
vanglória	raiva
inexistência	surpresa
desenho	tristeza
solércia	alegria
mascarra	medo
acirrar	nojo
prosápia	raiva
pouquidade	surpresa
distintivo	tristeza
luminescência	alegria
tacha	medo
espicaçar	nojo
requerimento	raiva
desprovimento	surpresa
emblema	tristeza
cintilação	alegria
tara	medo
acicatar	nojo
petição	raiva
carestia	surpresa
cicatriz	tristeza
clarão	alegria
tatuagem	medo
açodar	nojo
reclamo	raiva
absentismo	surpresa
gilvaz	tristeza
fulguração	alegria
a não ser	medo
interceder	nojo
aplicado	raiva
carece	surpresa
rugas	tristeza
lume	alegria
à exceção de	medo
intrometer-se	nojo
atento	raiva
deixa	surpresa
escara	tristeza
nitescência	alegria
afora	medo
imiscuir-se	nojo
dedicado	raiva
larga	surpresa
jaez	tristeza
virtuosismo	alegria
exceto	medo
ingerir-se	nojo
esforçado	raiva
desencaminho	surpresa
cepa	tristeza
pomposidade	alegria
menos	medo
mexer	nojo
bandeira	raiva
transviamento	surpresa
perfil	tristeza
lustro	alegria
salvante	medo
meter-se	nojo
dístico	raiva
atalho	surpresa
atributo	tristeza
cocaína	alegria
salvo	medo
enxerir-se	nojo
divisa	raiva
vereda	surpresa
peculiaridade	tristeza
coca	alegria
tirante	medo
opinar	nojo
claro	raiva
escaninho	surpresa
característica	tristeza
luminância	alegria
caso contrário	medo
dizer	nojo
níveo	raiva
desvão	surpresa
faculdade	tristeza
existência	alegria
de outra forma	medo
falar	nojo
nevado	raiva
recanto	surpresa
individualidade	tristeza
época	alegria
de outro modo	medo
manifestar	nojo
ebúrneo	raiva
recôndito	surpresa
confins	tristeza
fase	alegria
do contrário	medo
deliberar	nojo
ebóreo	raiva
peculato	surpresa
estremadura	tristeza
ciclo	alegria
quando não	medo
gerir	nojo
alabastrino	raiva
chave	surpresa
beira	tristeza
era	alegria
mas sim	medo
dirigir	nojo
inocente	raiva
descomposição	surpresa
baliza	tristeza
estágio	alegria
destrutibilidade	medo
manobrar	nojo
cândido	raiva
descompasso	surpresa
fronteira	tristeza
idade	alegria
indefensibilidade	medo
comandar	nojo
casto	raiva
despreparo	surpresa
estrema	tristeza
duração	alegria
desaperto	medo
imperar	nojo
impoluto	raiva
desafinação	surpresa
raia	tristeza
estação	alegria
largura	medo
participar	nojo
límpido	raiva
deselegância	surpresa
confim	tristeza
período	alegria
amplidão	medo
comparecer	nojo
albugínea	raiva
dessimetria	surpresa
limite	tristeza
ser	alegria
amplitude	medo
suceder	nojo
esclera	raiva
dissonância	surpresa
arraia	tristeza
ganha-pão	alegria
largo	medo
sobrevir	nojo
esclerótica	raiva
conversão	surpresa
medida-padrão	tristeza
manutenção	alegria
latitude	medo
acontecer	nojo
alva	raiva
transfiguração	surpresa
bitola	tristeza
assistência	alegria
liberdade	medo
ocorrer	nojo
clara	raiva
muda	surpresa
craveira	tristeza
provisão	alegria
prolixidade	medo
irromper	nojo
vísceras	raiva
metamorfose	surpresa
assinatura	tristeza
passadio	alegria
parança	medo
prorromper	nojo
entranhas	raiva
substituição	surpresa
rubrica	tristeza
mantença	alegria
refolgo	medo
desatar	nojo
intestino	raiva
permuta	surpresa
anotação	tristeza
biografia	alegria
férias	medo
explodir	nojo
pandulho	raiva
permutação	surpresa
borrifo	tristeza
relato	alegria
vacação	medo
estourar	nojo
público-alvo	raiva
comutação	surpresa
furúnculo	tristeza
memórias	alegria
sueto	medo
surgir	nojo
prático	raiva
comuta	surpresa
mata-borrão	tristeza
memorial	alegria
alargamento	medo
gerar	nojo
reto	raiva
recolocação	surpresa
respingo	tristeza
verve	alegria
desafogo	medo
produzir	nojo
firme	raiva
transportação	surpresa
sujo	tristeza
auxílio	alegria
respiro	medo
aguçar	nojo
positivo	raiva
móveis	surpresa
contaminação	tristeza
pilar	alegria
aliviação	medo
fomentar	nojo
lógico	raiva
câmbio	surpresa
lambuzadela	tristeza
sustentação	alegria
aliviamento	medo
avivar	nojo
racional	raiva
caixa de câmbio	surpresa
indicativo	tristeza
sustentáculo	alegria
detença	medo
instar	nojo
pragmático	raiva
desfile	surpresa
indicador	tristeza
arrimo	alegria
delgadeza	medo
promover	nojo
realista	raiva
corso	surpresa
índice	tristeza
ecossistema	alegria
tenuidade	medo
reavivar	nojo
explícito	raiva
mudação	surpresa
mímica	tristeza
fauna	alegria
acume	medo
vivificar	nojo
resoluto	raiva
mudada	surpresa
evidência	tristeza
flora	alegria
treta	medo
conquistar	nojo
determinado	raiva
reformação	surpresa
vislumbre	tristeza
holocenose	alegria
palor	medo
envolver	nojo
imparcial	raiva
remanejamento	surpresa
pegada	tristeza
qualidade de vida	alegria
palescência	medo
prender	nojo
isento	raiva
remodelação	surpresa
anúncio	tristeza
expressão	alegria
esqualidez	medo
alicerçar	nojo
neutro	raiva
remodelagem	surpresa
auspício	tristeza
desenvoltura	alegria
lividez	medo
basear	nojo
justo	raiva
remodelamento	surpresa
agouro	tristeza
princípio vital	alegria
desleixamento	medo
declarar	nojo
apartidário	raiva
reorganização	surpresa
augúrio	tristeza
personalidade	alegria
desmazelamento	medo
explicar	nojo
desapaixonado	raiva
resmuda	surpresa
sonido	tristeza
psique	alegria
imprevisão	medo
fundamentar	nojo
equânime	raiva
reviramento	surpresa
rede	tristeza
indivíduo	alegria
desazo	medo
respaldar	nojo
neutral	raiva
viração	surpresa
campainha	tristeza
pessoa	alegria
espandongamento	medo
imbuir	nojo
exterior	raiva
somação	surpresa
semáforo	tristeza
boca	alegria
médico	medo
impressionar	nojo
real	raiva
metamorfismo	surpresa
sinaleira	tristeza
bocal	alegria
cirurgião	medo
propor	nojo
concreto	raiva
alomorfia	surpresa
sinaleiro	tristeza
habitantes	alegria
físico	medo
governar	nojo
material	raiva
oura	surpresa
luminoso	tristeza
moradores	alegria
advogado	medo
cantar	nojo
utensílio	raiva
vagado	surpresa
caução	tristeza
aguilhão	alegria
bacharel	medo
encabeçar	nojo
instrumento	raiva
reprodução	surpresa
garantia	tristeza
aguilhada	alegria
escriba	medo
ministrar	nojo
agente	raiva
produção	surpresa
depósito	tristeza
ferrão	alegria
rabino	medo
reincidir	nojo
mercadoria	raiva
tiragem	surpresa
fiança	tristeza
ponta	alegria
professor	medo
repetir	nojo
artigo	raiva
edição	surpresa
arras	tristeza
pua	alegria
PhD	medo
insistir	nojo
planejamento	raiva
lançamento	surpresa
comprovação	tristeza
torcida	alegria
asclépio	medo
obstinar-se	nojo
planeamento	raiva
figura	surpresa
testemunho	tristeza
exortação	alegria
opcional	medo
repisar	nojo
esboço	raiva
estampa	surpresa
placa	tristeza
indução	alegria
optativo	medo
teimar	nojo
esquema	raiva
gravura	surpresa
letreiro	tristeza
sapata	alegria
voluntário	medo
caber	nojo
planta	raiva
influição	surpresa
tabuleta	tristeza
embasamento	alegria
arbitrário	medo
cair	nojo
rascunho	raiva
estúrdia	surpresa
etiqueta	tristeza
esteio	alegria
eletivo	medo
referir-se	nojo
delineamento	raiva
raridade	surpresa
ciente	tristeza
escora	alegria
alternativo	medo
concernir	nojo
debuxo	raiva
estroinice	surpresa
nome	tristeza
contribuição	alegria
discricionário	medo
pertencer	nojo
desvairo	raiva
altanadice	surpresa
jamegão	tristeza
encorajador	alegria
terapêutico	medo
aludir	nojo
tresvário	raiva
prosa	surpresa
imundície	tristeza
acendedor	alegria
medicativo	medo
voltar	nojo
lenda	raiva
fanfarrice	surpresa
borra	tristeza
estimulador	alegria
curativo	medo
retornar	nojo
mito	raiva
farofa	surpresa
fezes	tristeza
incitador	alegria
método	medo
retomar	nojo
mitologia	raiva
desgarre	surpresa
lixo	tristeza
incitante	alegria
mecanismo	medo
regressar	nojo
idealidade	raiva
unicidade	surpresa
caceteação	tristeza
instigador	alegria
processo	medo
recuperar	nojo
boniteza	raiva
especificidade	surpresa
chateza	tristeza
aposta	alegria
porta	medo
recobrar	nojo
batalhação	raiva
pessoalidade	surpresa
chatura	tristeza
atiçamento	alegria
fórmula	medo
tombar	nojo
contumácia	raiva
unidade	surpresa
maçadoria	tristeza
forca	alegria
receita	medo
descer	nojo
desdobramento	raiva
especialidade	surpresa
pontapé	tristeza
acicate	alegria
apelação	medo
bater	nojo
recalcitrância	raiva
faceta	surpresa
amuamento	tristeza
